糯米 团是 小时候 记忆 吃 好吃 小时候 油条 硬 油茶 还好 试试 	__label__0
满满的 五星 好评 口味 好 服务 好 特别 喜欢 昨天 第一次 买 今天 回购 买 刨 奶 店长 问 我加 腰果 核桃 说 随便 问 喜欢 吃 说 喜欢 帅帅 店长 我加 超赞 	__label__0
好喝 再 买来 喝 排队 人太多 	__label__0
三个 人订 四人餐 菜量 吃 完 问道 不错 	__label__0
好 一如既往 真真 爱上 自助 炒饭 自助 八宝粥 自助 冰粉 喜欢 所有 菜 肉 两女一男 吃 两份 两人餐 吃 完 饮料 不错 有空 就要 	__label__0
太 tmd 难吃 狗屎 草 	__label__0
火锅 味 味道 比渝 李记 火锅 米线 味道 好吃 一种 火锅 感觉 划算 韭菜 叶 好 喜欢 吃 韭菜 叶 面 	__label__0
今天 肯定 走 饿坏 宝宝 	__label__0
差评     饭 馊 根本 吃不下 再也不会 点 菜 问题 吃饭 被迫 买 方便面 下菜 ............. 	__label__1
分量 足 态度 没得说 原来 吃 今天 看到 刚上 团购 经理人 很帅 送 砸 果籽 	__label__0
一如既往 好 菜品 好 服务 更好 	__label__0
真的 不错 呦 味道 鲜美 吃 柠檬 有点 带酸 米线 颜色 总 感觉 怪怪的 感觉 原味 更鲜 好吃 下次 好 想 试试 原味 回 一趟 大学城 太远 掉 一个 黑椒 牛肉 乌冬面 不错 	__label__0
重庆 吃 最 满意 一家 日料 服务 满分 味道 满分 送 吃 西瓜 之前 元宵节 送 吃 汤圆 	__label__0
天下 最 难吃 东西 	__label__0
里面 虫子   太 恶心   吐 死 	__label__1
炒 苕 尖 太 难吃 吃 	__label__0
奶茶 味道 不错 鸡蛋 仔要 现做 需要 脆脆 好吃 	__label__0
天 蚊子 份量 太太 太太 少 好几十 全是 西海 椒 芹菜 老板 做生意 不好 	__label__1
筷子 害 买 叉叉 	__label__0
点 蒜蓉 香辣 两个 口味 小龙虾 虾 太小 肉 味道 配菜 还点 蛋炒饭 下单 前 看到 评论 里 说 蛋炒饭 亮点 好吃 惨不忍睹 深度 怀疑 历史 好评 是不是 水军 如果说 一定 找个 亮点 勉强 包装 送 两罐 加多宝 呵呵 	__label__0
这是 第二次 第一次 晚 忘 预约 好久 这次 早早 跑 过去 一如既往 好吃 服务 超赞 俩 人点 两人份 吃 完 包 哈哈哈哈 强烈推荐 	__label__0
味道 很赞 	__label__0
看着 好吃 样子 	__label__0
烤鸭 好吃 价格 实惠 	__label__0
在家 楼下 老板 人 好 味道 超级 棒 	__label__0
感觉 不错 买 试试 	__label__0
顾客 傻子 这家 店 买 现场 买 样子 外卖 顾客 现场 挑选 货物 满意 现场 换 专门 挑烂 西瓜 看看 钥匙 放在 现场 买 蓝莓 盒子 汁 一股 酸 臭味 坏 好 蓝莓 知道 干燥 上面 一层 白白的 东西 打开 全是 湿 买 两盒 两盒 我晕 以后 再也 这家 店 买 	__label__1
最 难吃 干锅 难吃 佩服 	__label__0
诚信 忽悠 人 难吃 	__label__0
吃 不错 	__label__0
味道 真心 不错 两人来 两份 油闷 大虾 清蒸 好吃 下次 一定 再 	__label__0
花生 吃 两颗 坏     品质 说     花钱买 糟心     希望 其他人 想 好 买 	__label__1
超级 难吃 再也 不吃 烤鱼 	__label__0
菜品 丰富 好吃 服务员 服务态度 超级 好 老板 考虑 加工资 	__label__0
太差 蚊子 饭 里面 	__label__1
本来 已经 漏 油 没想到 吃 一半 吃 出个 蟑螂 腿 艹 真 恶心 人 再也不会 点 	__label__1
不错 环境 挺 好 价格 棒 石锅 拌 饭 真的 好吃 好吃 超 好吃 排队 时间 有点 晚 轻轨站 楼梯 下来 顺边 容易 找到 	__label__0
花甲 一点 新鲜             忍       第一次 点 外卖 花甲         鸡蛋       从来不 人 差评 真的 今天 忍     商家 看看 恶 恶心       吃 好几个 看到     好怕 拉肚子       扔 垃圾桶 里 之后 感觉 整个 屋 	__label__1
招待 小姐姐 超级 温柔 团购 态度 不好 还给 建议 打包带 回来 吃 还好 庆幸 化 天气 第一次 吃 千层 奶油 幸好 伤人 好吃 住 南坪 装修 偶然 沙坪坝 忍不住 团   芒果 班戟   芒果 千层 	__label__0
菜品 新鲜 味道 地置 好找 值得 推荐 	__label__0
	__label__0
味道 好 老板 服务员 态度 好 环境 不错 吃 几次 	__label__0
送 接近 两个 小时 送       还少 一半 东西     两份 饭 一份       点 东西 一个 15 套餐 送     确实 牛批     点 知道 	__label__0
太好 太好 太好 真的 真的 太好 只 想 说 酸奶 紫米露 真的 值得 品尝 酸奶 紫米露 真的 好喝 健康 美味 天 天 忍 喝 想 喝 知名度 真的 好喝 好喝 每年 服务态度 特别 特别 特别 特别 特别 特别 值得 品尝 特别 特别 特别 喜欢 家 真的 西 酸奶 紫米露 好喝 话 口感 各有不同 特别 特别 爱 	__label__0
好 棒 好 棒 贵 觉得 好值 鹅 肝 有点 小 遗憾 质量 真的 好 海鲜 特别 新鲜 扇贝 鳕鱼 好吃 生 蚝 有生 吃 更好 鱼 生 不错 种类 挺 反正 重庆 吃 最 好吃 日料 赞 服务 热情 	__label__0
好吃 可惜 今天 吃 凉面 凉皮 好吃 饮料 团购 划算 	__label__0
顾客 团购 超极 划算 小吃 汤园 	__label__0
超级 喜欢 香菜 牛肉 鸡 脆骨 血旺 好 喜欢 好 喜欢 下次 还要 吃 人太多 一定 提前 订 	__label__0
鸡排 不错 够 大块 有点 烫 人 	__label__0
黑 钻 奶茶 好喝 腻 甜 味道 适宜 	__label__0
外卖 时间 太长 一个半 小时 送到 睡 夜宵 开花 肠买 特惠价 起码 碗 里 一个 丫 	__label__0
味道 不错 东西 货真价实 美女 老板 十分 热情 	__label__0
蛋糕 好吃 不错 不错 喜欢 	__label__0
饭 里面 虫子 鱼腥味 重 一点 新鲜 感觉 	__label__1
环境 不错 服务态度 好 适合 小孩子 玩 	__label__0
无 食欲 可言 	__label__0
空调 不足 太热 	__label__0
菜品 好 分量 很足 服务态度 好 01 	__label__0
第一次 地址 东原 新 新 park 儿童节 人 下 菜单 价格 偏贵 味道 感觉 不差 好 希望 折扣 一点 现在 价格 感觉 实惠 服务态度 好 甜品 速度 很快 希望 越来越 号 	__label__0
朋友 吃 有点 吃不完 	__label__0
菜品   丰富   味道 好吃   速度 	__label__0
第一次 吃 挺好吃 这次 点 一个 骨肉相连 那肉 有点 	__label__1
两个 人 吃 完 拉肚子     再也 点 家 	__label__1
味道 太 差 这次 最 糟糕 一次 日本料理 完全 浪费 鳗鱼 机会 一块 吃 	__label__0
好 离家近 味道 不错 值得 推荐 	__label__0
味道 超级 棒 美女 老板 好 喔 环境 没得说 妈妈 再也 不用 担心 吃 不到 梁山 鸡 	__label__0
好吃 说好 泡 脚 鹅掌 没撒子 辣椒 那种 味道 	__label__0
速度 太慢 饿 扁 	__label__0
味道 不错 少 点 环境 好 推荐 	__label__0
精品 全家福 炒饭 爆款 ➕ 例汤   加菜 加辣   味道 好吃 	__label__0
身为 一个 吃海鲜 长大 沿海 人   说 这家 鱼肉 很棒   鱼汤 特别 鲜   好评 没得说 ๑ Ő ௰ Ő ๑ 	__label__0
黑心 商家 地沟油 吃 拉肚子   配送 到位   宝宝 再 上当 	__label__1
很赞 吃 很饱 服务 不错 下次 还会 	__label__0
味道 不错 好喝 店员 服务态度 好 	__label__0
尖椒 鸡外 图片 实物 完全 不符 全是 干辣椒 土豆片 中有 葱 蒜 台 感觉 像是 几个 菜 混合 像是 剩菜 样 	__label__0
环境 不错 菜品 不错 光顾 	__label__0
油 不好   卫生   难吃   量 太少   菜 里面 钢丝 球掉 东西 锅 真的 洗 干净 	__label__1
第二次 姐姐   人 真的 好 爆炸 蹦蹦 蹦   哈哈哈哈 每次 见到 姐姐 开心   有点 害羞 哈哈哈哈   谢谢 姐姐 送 小 礼物   开心 	__label__0
干净 打开 后 头发 恶心 商家 	__label__1
说实话 好吃 没得 店里 好吃 鸭掌 一股 腥味 	__label__1
太 难吃 不合 重庆 人 口味 	__label__0
不错 下次 继续 味道 好 	__label__0
土豆片 ## 藕片 熟 送来 拉肚子 做 熟 发货 	__label__1
分量 足 味道 好 团购 划算 强烈推荐 	__label__0
味道 棒 朋友 特别 喜欢 吃 炒蟹 味道 最棒 蟹壳 炸 香脆 环境 好 请客 面子 	__label__0
明明 点 三份 番茄 鸡蛋 盖饭       却 一份       还少 送 两份 饭       打电话 手机 关机       第一次 看到 商家       垃圾     差评 	__label__0
一家人 吃 味道 兔子 肉 特别 嫩 五分 鼓励 鼓励 	__label__0
味道 行 菜 老店 	__label__0
好吃 扔 以后 再 买 	__label__0
味道 相当 不错 人 排队 速度 	__label__0
味道 好   紫米 好吃   加冰 更好 喝   美容 养颜 必备 佳品 	__label__0
量 真的 少 可怜 不想 说 顾客 傻子 重庆 不想 骂人 	__label__0
口感 好 老板 人 好 比较 老板 送货到 家 说 老板 害怕 弄坏了 非 送到 指定 地点 这次 团购 满意 送货 速度 	__label__0
口味 好 两个 人 吃 中 锅量 很足 排骨 够吃 	__label__0
牛排 做 	__label__0
不错 额 第二次 感觉 不错 性价比 超高 以后 还会 光顾 	__label__0
很棒 吃 好 几次 今天 人少   七个 人 吃 完 羊肉 细腻 太 喜欢 吃 皮 太焦 味道 不错 觉得 沾料 太咸 	__label__0
东西 送来   水洒   配送 员 听见   打电话 店里   说 本来 送   感觉 送 开心   真是 搞笑     这杯 饮料 钱 没算到 里面 一起     送 这种 态度     差评     再也不会 买   导购员   力量 很小   总 态度 相信 人 	__label__0
味道 好   好 几次   喜欢 	__label__0
好 好 好     环境 舒适       服务态度 好 	__label__0
牛 蹄筋 真不知道 肉 骨头 连起 味道 实体店 好吃 	__label__0
一如既往 好 态度 越来越 新意 	__label__0
真的 差评 一直 忍着 退货 真的 晚 接近 一个 小时 不说 时间 四个 电话 不接 准时 送到 早 说 突 况 打个 电话 要死 确定 取消 重新 下单 苦苦 真的 商家 有毒 不信 试试 真是 差评 少点 人 骗 确认 收单 恶心 	__label__0
送餐 太慢   本来 饿   还花 一个多 小时 	__label__0
菜品 好 服务 更好 	__label__0
鱼 味道 真的 好 鱼肉 鲜嫩 入味 面上 花椒 香味 四溢 确实 好吃 外面 吃 最 好吃 鱼 吃 后面 不腻 菜 团购 人餐 四个 人 吃 吃 完 食量 不小 吃 撑 撑 可惜 拍照 端来 超级 食欲 	__label__0
味道 好 环境 安逸 菜品 再 多点 完美 	__label__0
差评 起码 一个 小时 	__label__0
来过 鱼 嫩 味道 不错 配菜 好吃 一个 炸鸡 柳 东西 好吃 	__label__0
味道 不错 服务 已经 吃 一如既往 好 	__label__0
蛋糕 新鲜 好吃 物 廉价 美的 	__label__0
食物 种类 海鲜 牛排 面点 热菜 凉菜 喜欢 自助 烤肉 比较 乐趣 调味 牛排 好吃 很大 一份 煎 比较 嫩 限量 打牙祭 朋友 水果 新鲜 种类 店员 服务态度 好 推荐 一个 APP 说 吃 钱 返回 环境 宽敞 适合 朋友 聚会 这次 试一下 下次 会多带 一些 朋友 过来 朋友 推荐 价格 不贵 物超所值 赞 	__label__0
头发 好几根 肥 牛肉 吃 进 嘴里 丧尽天良 几十块 钱 打水漂 说 饿着肚子 看着 一盒 发臭 盒饭 气晕 评价 评价 里 人 遭遇 头发 忍 肉 吃 哭 晕 厕所 	__label__1
下回 再 骗人 	__label__0
送来 冷冻 筷子 用具 吃 一个 拉肚子 直接 扔 再也不会 买 这家 东西 第一次 买 差 大失所望 	__label__1
椒 麻鱼 ## 梭边 鱼 ## 酸菜鱼 ## 夫妻 肺片 好吃 推荐 请客 必备 面子 	__label__0
环境 不错 位置 好找 介绍 不错 去试 一次 实惠 份量 足 一份 小龙虾 一份 螺丝 一个 毛豆 一个 蒜泥 黄瓜 味道 不错 香辣 吃 不错 值得 推荐 去过 试尝下 	__label__0
老板 送过来 蛋糕 好 好评 	__label__0
逛街 看见 好多 人 买 喝   买 一杯   好喝     味道 棒棒 哒     ´ ･ ᴗ ･   	__label__0
服务 特别 好 菜品 新鲜 环境 舒适 	__label__0
豆腐 异味   变味 	__label__1
鱿鱼 有股 味儿 晓得 太腥 	__label__1
筷子 没得     手 抓 	__label__0
第一次 味道 不错 菜 性价比 高 	__label__0
真的 好吃 真是 棒棒 	__label__0
两位 美女 态度 好 耐心 教 小朋友 两位 小朋友 开心 坏 吵 下次 还要 做 蛋糕 	__label__0
顾客 真心 不错 值得 分享 	__label__0
点 凉粉 吃 以外 太 难吃 茄子 一个 酸 臭味 烧白 盐巴 酱油 钱 白肉 一个 腥臭味 备注 说 米饭 舀 软 一点 全是 夹生饭 一个 酸 臭味 包装 吃 最 难吃 小碗 菜 	__label__1
	__label__0
泡椒 耗儿 鱼 难吃 卖相   一条 大耗 儿鱼 分量   老板 说 两个 人   只 一双 筷子   花甲 味道   感觉 再 这家 店 58 买 一只 鱼 	__label__0
反正 好 一如既往 好 喜欢 比较 便宜 很值 	__label__0
根本 鱼香肉丝 宫保鸡 丁 味道 点 好吃 说 巨 难吃 速度 特慢 菜品 正宗 说 味道 差得 太远 	__label__0
价钱 便宜 味道 不差 米饭 口味 	__label__0
好 好吃 便宜 实惠 	__label__0
挺 好 门店 小 点 味道 不错 	__label__0
呵呵 已经 不想 再订 直播 吃屎 	__label__0
奥尔良 鸡翅 上面 毛 吃 最差 一次 鸡翅 	__label__1
老板 姐姐 善人 好   味道 超级 棒   喜欢 喜欢 喜欢 	__label__0
饭 馊 打饭 闻 不到 打电话 商家 商家 说 解决 不了了之 老板 卖得 好 不差 几个 顾客 	__label__1
强烈推荐 紫米 酸奶 好喝 环境 好 店 美女 热情 招呼 整个 制作 过程 很快 酸奶 喝 健康 物有所值 一次 团购 	__label__0
牛肉 炒 刀削 只得 两片 牛肉 头发 差评 	__label__0
不错 服务态度 好 味道 不错 	__label__0
再次 光顾 琳琅 录音棚 酒吧 服务 一流 舒适 温馨 专业 录音 设备 满意 	__label__0
人 吃     肥肠 烧糊     里面 配菜 湖     肥肠 一点儿 味儿     各位朋友   只能 说 再点     垃圾 	__label__0
今天 再 勺 皮 里面 吃 一块 胶纸 真的 恶心 	__label__1
味道 棒棒 哒 找 地方 时 找 好久 明明 好找 地方 走 反 方向 	__label__0
这次 米饭 真的 吃 有史以来 最 难吃 米饭 觉得 成本 原因 买 那种 特别 差 米 老板 开 饭店 米饭 重要 吃 夹生 夹生 真的 说不出 口感 吃 点 下去 胃 疼 差评 希望 商家 看看 意见 	__label__0
老板娘 热情 	__label__0
不错 味道 好 服务态度 不错 价格 小贵 	__label__0
卫生 吃 拉肚子 	__label__1
味道 不错 零嘴 吃 挺不错 	__label__0
吃 几次 味道 不错 服务 热情 	__label__0
味道 不错 喜欢 吃 	__label__0
吃 一如既往 好 环境优美 服务 热情 赞 	__label__0
最 喜欢   哈哈哈   一周 几次 	__label__0
超 划算 贝尔 麦莎 蛋糕 好吃 我家 女儿 大爱 	__label__0
真的 认真 点评 下 想 吃 日料 老公 两家 店点 餐 想 考察 下 住家 附近 哪家 店 好吃 配送 来说 配送 时 不停 收到 配送 员 电话 第一次 送 找 不到 路 理解 不停 打电话 几个 意思 不能自己 定个 位 说 小区 不让 进 怎么回事 老公 点 餐 已经 送到 家里 能进 进不来 走 小区 门口 餐 第一次 感受 外卖 送餐 上门 下 菜品 点 刺身 一起 配送 酱油 芥末 还好 老公 点 那份 里面 放在 袋子 里 冰袋 八爪 鱼刺 身 冻得 冰 咬 咬 不动 花 之恋 里面 水 扎扎 	__label__0
餐具 	__label__0
送得 太慢   高兴   饿死 	__label__0
挺 好 量 合适 有点 晚 肥肠 点 里脊 鱿鱼 老板 热情 时不时 加水 添饭 吃 后面 有点咸 好 	__label__0
难吃 出新 高度 	__label__0
味道 不用说 霸道 知道 第几次 吃 	__label__0
好吃 服务态度 特别 好 环境 干净 东西 真 好吃 一直 吃 不停 下次 一定 还会 	__label__0
味道 不错 环境 上菜 速度 	__label__0
这家 店 吃 好 第一次 吃 难吃 全是 糊味 鸡 馊 情况 打电话 店家 告诉 鸡 馊 承认 好 只能 自认倒霉 看到 一坨 兔子 绑 一条 扯 扯 掉 红色 线 十公分 长 请问 蚕 吐丝 店家 说 退 十块钱 呵呵 一顿 愉快 饭 图一 剩下 吃 觉得 十块钱 够 补上 这顿 60 饭 	__label__1
确定 煮 刀削面 拉面 味道 好 难吃 	__label__0
挺好吃 服务 好 价格 实惠 好 几次 以后 还会 光顾 不错 不错 满意 	__label__0
菜 挺 好 预约 说 火大 烫伤 几次 问候 帮 关火 服务态度 真心 不错 环境 不错 挺 喜欢 西瓜 吃 吃 好多 不管怎么 说 反正 爱 猪血   好吃 	__label__0
菜品 新鲜 环境 好 满意 	__label__0
味道 不错 挺 热闹 地方 吃 现杀 活羊 	__label__0
不错 不错 不错 买 几次 	__label__0
顾客 店铺 很大 环境优美 节假日 歌手 助唱 牛排 鲜嫩 好吃 没去 朋友 尝试 一次 赞 	__label__0
太 难吃 再也 不买 想 退钱 最 讨厌 吃 鸭肉 大肉 串 明显 一股 死 鸭味 吃 一口 全 扔 面筋 第一次 尝试 荤菜 好吃 鸡翅 冰冻 蜜蜡 鸡肉 味道 鱿鱼 新鲜 知道 好评 是不是 买 现在 冰冻 串肉 红色 那种 一个 味 真怕 死耗子 肉 	__label__0
一次 朋友 喝茶 朋友 说 不错 	__label__0
味道 不错   服务态度 超好   周到 	__label__0
味道 不错 田螺 好吃 下次 还要 	__label__0
选 大娘 水饺 牌子 卫生 想 问 一句 年 水饺 今天 晚上 拉肚子 	__label__1
不错 第二次 吃 性价比 服务态度 一流 牛排 意面 很棒 披萨 挺好吃 芝士 果汁 好喝 真的 愉快 享受 	__label__0
一共 份 那份 泡椒 肉丝 闻着 有点 酸 以为 泡椒 酸味 吃 完 下午 拉肚子 以后 再 吃 这家 味道 不怎么样 两份 同事 说 味道 不行 	__label__1
三个 大人 吃 不错 味道 服务态度 好 	__label__0
月 月 服务态度 好   菜品 一如既往 好吃   特别 推荐 烧椒 小 皮蛋 	__label__0
味道 好     服务 好 	__label__0
好 合胃口 辣 	__label__0
味道 不错 老板 热情 	__label__0
太慢 饭 吃 饿死 	__label__0
有个 菜 我点 差评 	__label__0
慢 骗人 再三 确认 说 送到 楼下 门口 好久 	__label__0
今天 买 臭豆腐   真的 有毒   女朋友 拉肚子 好 几次 	__label__1
好 购买 服务 挺 到位 有种 酸奶 有种 儿时 味道 	__label__0
老板 人 不错 虾子 味道 好 试哈 	__label__0
第二次 感觉 辣味 好像 第一次 辣 建议 辣酱 单独 成碟 顾客 加 增加 洗碗 工时 客人 拌 小心 倒 得到 处 各有利弊 	__label__0
好 上菜 环境 很漂亮 服务 周到 热心 菜色 好看 味道 不错 关键 价格 真的 贵 人才 吃 144 元 强烈推荐 	__label__0
说实话 价格 来说 已经 相当 超值 位置 找 解放碑 大都会 楼 唯一 不足 服务员 阿姨 级别 服务态度 热情 反应速度 稍慢 点 交流 有点 总体 来说 69 元 划得来   烤 牛排   牛排   北京烤鸭   鸡蛋 布丁   烤 虾   龙利鱼 	__label__0
味道 做 好吃 	__label__0
好   阿姨 态度 和蔼   排骨 好吃 两人 绰绰有余   唯一 环境 差点 	__label__0
环境 干净 菜品 新鲜 服务态度 好 	__label__0
粥 全部都是 水 一勺 舀 下去 稀 看着 恶心 馊 不及 店里 三分之一 饺子 三个 外卖 筷子 勺子 碗 还收 贵 配送费 三个 菜 100 美团 第一 差评 送给 谢谢 	__label__1
吃 一个 发霉 鸭 爪 鸭 骨架 问题 味道 好 	__label__1
顾客   夏天 喝 尤其 安逸   推荐 推荐 	__label__0
尼玛 第一次 订单 吃 拉肚子 20 几次 差点 死 尼玛 这家 店真 卫生 现在 医院 输液 	__label__1
好 好 味道 好 选 口味 	__label__0
味道 不错 菜品 新鲜 点 半份 适合 人 吃   吃 几个 菜 服务 好 环境 	__label__0
味道 好 口味 棒 辣 爽 吃 安逸 分量 强烈推荐 	__label__0
便宜 味道 好 不错 	__label__0
口味 好   量 够 汤 之前 好 	__label__0
吃 好 几次 喜欢 米 饼 可惜 锅 斜 看着 舒服 	__label__0
味道 摆   家常便饭   完美   十年 忠实 顾客 	__label__0
吃 虫     厉害 厉害 	__label__1
豆干 邵皮 送 	__label__0
虾 好吃 份量 足 唯一 鸡 咸 一点点 朋友 超爱 土豆丝 江景 真要 赞 一下 	__label__0
帮 朋友 现在 涨价 吃 几次 	__label__0
筷子 没得   吃 	__label__0
吃 吃 容易 饿 	__label__0
份量 充足 不错 	__label__0
蛋糕 好 好吃 很漂亮 	__label__0
我定 两份 饭 却 只 送 一份 饭 	__label__0
一如既往 地好 包间 够 味道 	__label__0
确实 不错 一如既往 好 继续 支持 	__label__0
甜甜 圈 味道 超级 棒 老板 好 	__label__0
位置 好找     环境 不错     晚上 每个 人 加 十块     菜品 新鲜   海鲜     晚上 人 挺     下次 再 新鲜 牛肉 ## 生 蚝 扇贝 ## 蟹 脚 ## 法式 髓 骨 牛排 ## 韩国 牛排 	__label__0
不爽 点 米饭 送 早说 米饭 不点 弄 家有 米饭 关门 	__label__0
已经 去过 几次     味道 好   分量 足     饭点 人     提前 排队 	__label__0
好吃 已经 第二次 买 划算 服务 方面 好 	__label__0
位置 好找 菜品 新鲜 环境 不错 老板 客气 	__label__0
味道 好吃 吃 好吃 以后 	__label__0
听 同学 说 这家 店上 630 美食 道 今天 尝尝 感觉 服务 特别 好 老板 性格 豪爽 味道 不错 满意 推荐 吃 	__label__0
鱼太咸 鱼 新鲜 异味 差评 	__label__1
已经 顾客 推荐 朋友 买 团购 力度 再大点 更好 	__label__0
配送 慢成 狗 以后 再也不会 这点 11 点点 点半 送到 饿死 人 	__label__0
饭 熟样   好像 昨天 剩饭   一点 好吃 	__label__1
送货员 态度 太 差 味道 难吃 	__label__0
地方 好找 味道 好 下次 还会 吃 	__label__0
好   吃   环境 菜品 不错 	__label__0
难吃   难吃 	__label__0
一如既往 好 吃 无数次 	__label__0
想不到 差 想不到 难吃 第一次 外卖 评价 	__label__0
炒 米粉 肉 糊 	__label__0
顾客 继续 光顾 	__label__0
三文鱼 新鲜 肉质 分层 158 元 大份 三文鱼 35 片 每片 4.5 元 28.8 元 小份 三文鱼 片 每片 3.2 元 158 元 至少 49 片 大份 少得 可怜 说 切大切 小 每种 分量 点 下次 太 黑心 	__label__1
菜 好吃 性价比 高 外地人 极力推荐 	__label__0
想 吃 炸熟 苍蝇   点 一下 掺 薯条 里 	__label__1
味道 好 服务质量 不错 离家 以后 还来 	__label__0
吃 N 订 N 太 好吃 	__label__0
说实话 虾子 确实 店家 送货 前 检查一下 食物 是否 坏掉 秘制 辣 卤鹅翅 ## 辣 卤鸭 头 两样 东西 打开 后 完全 酸臭 人 下 口 浪费 钱 说 吃 问题 	__label__1
良心 卖家 东西 不错 最 关键 留言 想要 一个 长得帅 外卖 小哥 老板 派 吴彦祖 级别 希望 老板 正视 错误 拿出 企业家 良心 小哥 微信 私 改 评价                                                                                                                 好 改 	__label__0
一个 小时 前刚 店里 点 大盘鸡 盖面 吃 一只 虫子 剩下 半碗 全 扔掉 关键 店家 态度 太 人 生气 承认 还给 说 菜 叶子 有见 长脚 长 眼睛 菜 叶子 更何况 我点 餐 菜 肯定 菜 叶子 干嘛 急 销毁 证据 筷子 抢过去 扔 垃圾桶 眼瞎 分不清 菜叶 虫子 这家 店 卫生 达标 以后 就餐 注意 点 这份 餐是 送 餐员点 今天 重庆 下 大雨 好 辛苦 点 两份 饭 今天 写出 评价 希望 以后 擦亮 眼 不干不净 东西 影响 身体健康 	__label__1
第二次 价格 合适 环境 不错 下午茶 好去处 	__label__0
火锅 味道 不错 菜品 丰富 量足 吃不完 鲜 毛肚   鲜鸭肠 	__label__0
米线 里面 虫 太 卫生 	__label__1
味道 不错 越 吃 越 味道 下次 	__label__0
太棒了 服务 好 好吃 便宜 划算 无可挑剔 堪称 完美 量足 三个 吃够 	__label__0
分量 足 六个 大人 吃 完 包 回家 呵呵 	__label__0
好吃     巴适 一如既往 好       下次 还来   	__label__0
送 好慢 几分钟 半小时 	__label__0
确实 吃个 饭 吃 钢丝 真的 醉 再也 不吃 	__label__1
定餐 送达 只花 20 分钟 提前 半个 小时 送到 诧异 烤串 速度 温热 里脊肉 没熟 签签 牛肉 夹带 一根 头发 少 藕片 醉 商量 后 商家 已退 藕片 里脊肉 钱 速度 重要 质量 第一 尤其 吃 进 嘴里 食物 以前 点 家 觉得 不错 这次 换 老板 愉快 一次 点餐 经历 	__label__1
推荐 番茄 牛尾 粥 原汁 排骨 好 咸 推荐 小炒 黄牛 不错 牛肉 很嫩 	__label__0
人 比较 少   人   速度 挺快 	__label__0
好吃 划算 已经 	__label__0
买 蛋糕 面包 好吃 	__label__0
点 你家 外卖 好 几次 推荐 朋友 这次 肚子 饥饿 点 没想到 送过来 鸡腿 太 失望 小心 吃 一块 担心 一会 还要 拉肚子 	__label__1
好吃 吃 几次 环境 好 	__label__0
说 辣 一点 辣 一点   不辣 吃 反胃 	__label__0
挺 好喝 酸奶 浓浓的 味道 不错 	__label__0
打开 发现 一根 头发丝 扔 几块 口味 不错 包装 不错 	__label__1
反正 每次 路过 吃 真的 好吃 几种 团购 买 奶茶 女儿 最 爱 比较 钟意 雪 糯米 老公 爱 金桔 柠檬 反正 一个 口味 好 美团 购买 划算 买 几杯 十来 块钱 以后 继续 关注 美团会 奖励 	__label__0
鱼 不错 	__label__0
老板   看看   蚊子 	__label__1
环境 优雅 口味 不错 	__label__0
味道 好   好喝 实惠 	__label__0
菜品 味道 超棒 	__label__0
天 刚刚 打开 一只 蟑螂 从袋 里 爬 身上 我能 说 认真 点行 家 顾客 头发 说   这次 太 	__label__1
难吃 吃 最 难吃 干锅 冷菜 混在 一起 排骨 两三个 骨头 里脊肉 几个 再次 声明 难吃 做 好吃 客户 最爱别 买 真的 太 难吃 钱 贵 骗人 一颗 星 送 外卖 人 难吃 难吃 真的 难吃 	__label__0
大清早 点 一个 外卖 送过来   冷冰冰     秒 懂   之前 先 做好 买   硬着头皮 吃 完 吃 找 有没有 放心 感觉   懂 	__label__0
环境 不错   服务周到 份量 足 味道 不错 套餐 包括 饮料 酒水 满意 	__label__0
顾客 不错 下次 还会 	__label__0
头发 饭里 骑手 不耐烦 	__label__1
味道 不错 位置 好找 百盛 下面 微 时代 旁边 值得 表扬 服务员 太 热情 看到 穿 浅色 衣服 特地 帮 围裙 弄 身上 亲切 说 无线网络 密码 顾客 确实 照顾 感受 值得 推荐 服务 再次 	__label__0
菜品 不错 菜量 口味 特别 好 	__label__0
吃 最 好吃 酥 肉 真的 喜欢 	__label__0
去过 好     一如既往 还好     下次 机会 回去 	__label__0
菜品 足 服务 好 	__label__0
觉得 好吃 专门 一次 烤 猪蹄 好吃 	__label__0
鱿鱼 吃 拉肚子 	__label__1
超级 超级 钟爱 蟹 籽 希望 再 多一点 蟹 籽 啊啊啊 啊啊啊 整体 口味 买过 几次 下次 一定 尝试 店里 坐 吃 享受 	__label__0
一个 人 觉得 好用 平价商店 	__label__0
环境 老板 贴心 地址 里面 说 清楚 走 里面 二号 厅 电梯 排队 进 电梯 人太多 上楼 即到 店内 环境 不错 挺 情调 包间 留 三个 人 不好意思 老板 圆桌 包间 坐 三张 桌子 房间 空调 力 舒服 菜品 老板 说 请 少 盐 少辣 味道 一点点 重 此次 体验 唯一 小 瑕疵 味道 挺不错 摆盘 造型 好看 评价 生死 炒 鱼肉 最 好吃 可惜 下面 鱼缸 小 金鱼 黑色 红色 卖相 试管 装 银耳 雪 蛤 水果 羹 好喝 蟹黄 豆腐 味道 很鲜 大赞 	__label__0
贡茶 真的 很大 杯 超级 便宜 	__label__0
搞起 手套 	__label__0
螃蟹 新鲜 	__label__0
一如既往 好 	__label__0
北碚 吃 味道 最好 火锅 人太多 等位 时间 长达 小时 菜品 新鲜 三人 消费 166 元 总体 满意 	__label__0
菜 不错 特色 	__label__0
贡茶 口味 不错 好喝 服务员 态度 	__label__0
点 份 土豆 却 看到 土豆 影子 包装 不好 油汤 倒 	__label__0
菜品 分量 足 人 吃 刚刚 好 值得 一去 	__label__0
不错 老板 特别 热情 环境 好 	__label__0
味道 巴适 服务 不错 许久 不吃 想念 	__label__0
牛排 不错 	__label__0
好 几次 味道 不错 两个 人 吃 好 剩 	__label__0
真的 太 难吃 	__label__0
男朋友 吃   点 一个 番茄 鸳鸯锅     感觉 番茄 汤 很浓   好喝   菜品 分量 足     服务 周到   服务员 年轻 小朋友   活力 十足 下次 还会 再 哒 	__label__0
送餐 太慢   不想 评论 	__label__0
做工 太差 好吃 	__label__0
老板 热情 菜 好吃 实惠 四个 人 完全 吃不完 好评 下次 一定 还来 	__label__0
知道 平菇 肉丝 肉片 盖饭 里面 尖椒 辣 吃 辣 两天 	__label__0
不错 味道 好 送货 很快 赞 一个 	__label__0
味道 好 地方 有点 偏 不好 找 团购 划算 赞 	__label__0
差评 差评 差评 十二点 十二分 下单   现在 一点 四十 送过来     问题 距离 不到 八百米     备注 加辣包 呵呵 一个 鸡腿 一对 翅膀 一共 一个 调料 包   知道 这家 送 外卖     一点 歉意   建议 要点 外卖 避开 这家   做生意 态度   倒闭 	__label__0
味道 嘿好 番茄 丸子 米线 丸子 番茄 有点 开心 	__label__0
味道 不错 环境 好 预订 久 	__label__0
店面 位置 好找 场地 小 卫生 方面 店家 服务 整体 还算行 接待 食客 挺 热情 验证 卷码 规矩 排队 验 工作效率 还算 高 菜品 半成品 现 加工 成 成品 点 鸡爪 爪 份量 由称 称 一份 折合 下来 价格 相比 划算 味道 来说 价格 相对 平衡 鸡爪 爪 味道 说不上 特别 特色 味道 挺 香 爽口 软 硬度 合适 小 食品 味 玩 挺不错 	__label__0
难吃 难吃 太 难吃 实体店 味道 差远了 	__label__0
太 难吃 光顾 咸了 有点 	__label__0
满意 味道 好 电影院 旁边 分量 值得 一吃 	__label__0
牛肉 坏 吃 真 郁闷 	__label__1
吃 蟑螂 好 妈 无语 送 半天 送 不来 	__label__1
筒子 骨约 800g 默认 宰断 不想 说 晓得 放 天 筒子 骨臭 晕 算 倒霉 30 块钱 算 倒霉 	__label__1
鱼 差 少 说 鱼 腥味 无语 	__label__1
分量 足 挺 好 下次 还会 	__label__0
榴莲 披萨 酸酸的 送 点多到 点多 呵呵 送 这么久 	__label__1
难吃 词 只 说 一次 这家 店 外卖 只点 一次 送来 菜 温 颜色 菜 口感 份量 真的 迷你 晓得 一分 价钱 一分货 价格 之前 点 家 份量 好 主要 味道 炸 土豆 软塌塌 肥肠 晓得 啷 形容 反正 应该 特别 新鲜 懒 人 会花 时间 写 多字 是因为 真的 好吃 代表 个人观点 觉得 好吃 吃 点 	__label__0
好吃 吃   鸡蛋 仔比 大通 冰室 好吃 	__label__0
一直 买 沁园 蛋糕 面包 吃 味道 好吃 买 一进店 里面 店员 热情 推荐 新 上市 芝士 蛋糕 正好 团 一张 买 吃 确实 口感 细腻 下次 还会 再 买 	__label__0
敲击 好吃 下次 还要 尝尝 	__label__0
好吃 速度 服务 好 不错 还会来 	__label__0
环境 不错 菜品 新鲜 分量 充足 服务 好 	__label__0
超级 好 老板 人 好 本来 以为 热 冰 意外 碰到 有人 吃 吃 	__label__0
实际 宣传 差距 太 口味 不行 重庆 吃 最烂 石锅 拌 饭 	__label__0
店面 装修 干净 整洁 老板 帅哥 人 好 服务 好 服务员 全部 白衣 白帽 看着 舒服 味道 好 	__label__0
一如既往 の 好 	__label__0
蛋糕 很漂亮 味道 棒 原材料 不错 吃 口感 好额 价格 不贵 经济 实惠 下次 还来 订 蛋糕 	__label__0
一个多 小时 	__label__0
说实话 晚上 见到 小虎 听到 小虎 唱歌 心里 真的 不爽 失望 	__label__0
吃 味道 好 价格 亲民 	__label__0
味道 好 过来 吃 下次 还来 尝尝 	__label__0
喜欢 喝 希望 一直 好 下去 	__label__0
好 店 吃 强烈推荐 	__label__0
吃 完 拉肚子 说 	__label__1
真的 无语 素 米线 盒子 变小 以前 觉得 汤 挺 好喝 今天 送来 糊都糊 最 恶心 翻到 蚊子 	__label__1
味道 不错 位置 好找 吃 微辣 后面 越 吃 越辣 三个 女纸 吃 四人餐 貌似 吃 尽兴 女 汉子 吖 下次 再 	__label__0
地方 好找 很近 老板娘 热情 味道 可爱 还会 买 	__label__0
嘴馋 几个 菜 动 后面 服务 一如既往 好 菜 任然 棒棒 哒 南坪 逛街 最 喜欢 吃饭 点 	__label__0
老板 人 好 一份 菜 分量 不够 主动 说 加 一个 菜 老板 说 知道   	__label__0
好喝 口感 好 	__label__0
点 几次 这份 田螺 实在 不敢 吃 前 几天 福寿螺 新闻 卖 福寿螺 外地 举报 重庆 知道 可不可以 田螺 样子 福寿螺 炒熟 吃 感染 大哥 知道 福寿螺 百度 一下 分辨 田螺 福寿螺 图片 送来 一直 说 小声点 大半夜 家里人 睡 特别 声音 敲门 说话 真的 无 语 	__label__1
没吃过 奇怪 难吃 烧烤 点 玉米 点 点 素菜 包括 青椒 商家 直接 送来 一个 奇奇怪怪 麻辣 青椒 炒 玉米 失望 心想 算了 青椒 炒 玉米 太 难吃 吃 一口 真的 奇怪 味道 青椒 辣 混合 油 辣子 海椒 辣 致电 商家 商家 说 我点 青椒 以为 弄 点 青椒 玉米 想 我想 问哈 真的 想 不该 点 青椒 说 太 难吃 玉米 钱 退 商家 死活 不干 说 撒子 本来 没点 钱 菜 这是 我点 钱菜 问题 商家 失 	__label__0
菜品 丰富 味道 不错 服务 到位 价格 方面 公道 下次 还会 再 	__label__0
日 啥子 几把 情况 第一次 点 吃 一个 蚊子 哪种 一个 小虫子 一根 成 头发 媳妇 直接 吃 欧 搞 麻批 搞 	__label__1
再 这家 店 傻 逼 菜 肉 一点 不说 好评 刷 商家 有点 良心 垃圾 实话实说 	__label__0
味道 不错 糍粑 特别 好吃 下次 再 	__label__0
好喝 好喝 每天 一杯 便宜 好喝 店员 服务 好 好喝 好喝 每天 一杯 便宜 好喝 店员 服务 好 好喝 好喝 每天 一杯 便宜 好喝 店员 服务 好 好喝 好喝 每天 一杯 便宜 好喝 店员 服务 好 好喝 好喝 每天 一杯 便宜 好喝 店员 服务 好 好喝 好喝 每天 一杯 便宜 好喝 店员 服务 好 	__label__0
蛋糕 实惠 卖家 送来 挺快 下次 再 	__label__0
太棒了 味道 好 值得 朋友 聚餐 真的 麻辣 	__label__0
上菜 味道 好 份量 足 服务周到 店面 小 环境 安静 优雅 梅子 酒 有点 特色 度数 低 女士们 一起 小酌 一下 不错 下次 还会来 朋友 推荐 真心 好 	__label__0
真的 好吃 全是 冰渣 三层 厚厚的 皮 一层 带冰渣 奶油 一小块 里 六粒 芒果 感觉 全是 皮 冰 口感 不好 	__label__0
位置 比较 好找 味道 好吃 分量 足 总体 来说 开心 	__label__0
好吃 菜品 新鲜 分量 足 	__label__0
服务态度 好 店员 热情 十分 好评 	__label__0
翻找 美团 发现 这家 抱 试一试 态度 过来 真心 好 好吃 全部 吃 完 很大 一条 鱼 太 划算 老板娘 态度 好 还配 荤菜 素菜 	__label__0
位置 馆 号门 对面 直走 500 米 林妹妹 沾水 米线 旁边 环境 比较 简洁 室内 为主 室外 一张 桌子 服务 挺不错 wifi 速度 杠杠 团购 验证 很快 老板娘 挺 热情 味道 酱 香味 确实 不错 香辣 太辣 土豆 好吃 下次 机会 试试 蟠龙 菜 	__label__0
环境 服务 好 下午 比较 早 人不多 一桌 打牌 禁止 客人 咖啡馆 大厅 打牌 显得 咖啡馆 宁静 专业 一点 咖啡馆 打牌 本地 习俗 关系 再 高档 咖啡厅 免不了 有人 打牌 这点 上面 苛刻 要求 总体 算 不错 	__label__0
好 不错 下次 再 	__label__0
顾客   套餐 相当 划算 推荐 	__label__0
说 送 冰红茶 看到     遁 	__label__0
味道 一点 好吃 里面 菜 入味 	__label__0
味道 分量 多足 资深 小龙虾 专业户 想 说 勒个 虾子 死 虾 放 一到 两天 虾子 虾肉 硬 反复 加热 导致 虾子 壳 壳 嫩个 难 拨 新鲜 虾 全部 捞 老板 真的 太 没得 职业道德 新鲜 虾子 少得 可怜 同行 污蔑 勒些 言子 解释 确实 同行 	__label__0
口感 不错 环境 还好 老板 热情 上菜 一点 好 	__label__0
好喝 一只 酸奶 牛 加冰 味 淡 这家 加冰 味道 很浓 这种 热死 人 天气 喝 确实 爽 	__label__0
一直 喜欢 这家 店 位于 长江 江畔 风景优美 味道鲜美 非常适合 朋友 聚会 	__label__0
一如既往 好吃 这次 一个 人去 	__label__0
咯 歌剧院 哈哈哈哈 	__label__0
吃 味道 不错 	__label__0
土豆丝 太 难吃 虫子 里面 	__label__1
环境 舒服 老板 细心 说 天气 凉 酒 喝 太冰 女生 肠胃 不好 一半 冰 一半 不冰 解放碑 啤酒 口感 不错 上面 有趣 重庆 言子 最 喜欢 吃 店 豆 干 牛肉 分量 足 味道 巴适 超级 下酒 这家 店 认准 	__label__0
狠 满意 味太差 吃 头发 投诉 	__label__1
真 不想 说 看着 食欲 	__label__0
位置 好找 两个 人 吃 吃 蒜 香味 一点 不辣 味道 超 好吃 吃 辣椒 最合适 选择 蒜 香 分量 两个 人 吃 吃 完 送 一个 小菜 老板 服务态度 好 强烈推荐 品尝 反正 满意 这次 用餐 	__label__0
饭 硬 冷 菜 真的 难吃   猪扒 三块   薄 纸 薄 咖喱 土豆泥 根本 咖喱 味   下次 再也 不买 这家 	__label__0
很多很多 以后 还会 再 味道 不错 	__label__0
好吃 环境 好 吃 团购 划算 	__label__0
分量 挺足 干捞 汤加 上碗 照出来 明显 味道 挺 好 辣油 别有 一番 风味 点 豆子 香味 米线 口感 糯 不失 筋道 棒 	__label__0
评价 好   每次 吃 美蛙 鱼头   直接 团 一个 98     情况 吃 爽   吃不完 菜   四个 人 够   麻辣味 好爽   配菜 好吃   路边 大排档 即视感   feel 	__label__0
团购 实惠 味道 不错 蒸汽 煮 鱼 速度 只用 分钟 推荐 下次 还来 	__label__0
长 大吃过 最 好吃 蛋糕 奶油 纯纯 重 牛奶 味 真的 听 下来 蛋糕 甜 配 奶油 甜而不腻 太棒了 配套 工具 太 喜欢 真的 太有 feel 超级 无敌 满意 以后 继续 购买 送货上门 优质 态度 希望 生意 越来越 好 	__label__0
味道 确实 太差 一点 味道 	__label__0
不错 ⊙ ▽ ⊙ 好吃 服务 好 	__label__0
位置 好找 狮子 坪 轻轨站 人不多 菜品 新鲜 品种 火锅 烤肉 一起 特色 牛排 不错 太小 还要 排队 酒水 葡萄酒 太差 感觉 兑 一点 酒味 服务 还好 值 价格 	__label__0
好吃 味道 上次 完全 	__label__0
服务 热情周到 细致 味道 美美 环境 好 免费 水果 沙拉 值得 希望 做 活动 常客 	__label__0
一如既往 喜欢 爱 吃 虾 店家 一次 弄 一盘 抢光 排队 久 扫兴 	__label__0
看到 无邪 入驻 重庆 第一 时间 拔草 抹 茶控 来说 大爱 龙湖 天街 号 门口 显眼 装修 风格 日式 开业 人 服务员 特别 热情 搞 紧张 哈哈哈 四个 人 每个 人点 一个 吃个 	__label__0
位置 比较 好找 环境 不错 味道 好 	__label__0
新开 电影 饿 	__label__0
油太多 好吃 太腻 	__label__0
时间 准确 实物 质量 太差 好吃 	__label__0
百分之百 死 虾 臭味 老板 开门 做生意 做 一个 商家 差评 算 第一个 	__label__1
第一次 吃 感觉 味道 不错 服务态度 挺 好 下次 还会 再 	__label__0
蔬菜 已经 过期 吃 完 拉肚子 	__label__1
味道 不错 有点 热 	__label__0
不错 挺 好喝 下次 还会 喝 	__label__0
第一次 来团 失望 比较 晚 排队 美女 服务态度 味道 喜欢 有点 辣 口味 分量 很足 好多 肉 反正 吃 完 浪费 下次 闺蜜 一起 吃 推荐 价廉物美 好 味道 棒棒 哒 	__label__0
物美价廉 上菜 很快 味道 不错 	__label__0
贵 不到 10   只 100 块 好吃 	__label__0
重庆 旅游 宝贝 睡着 说 找个 茶馆 休息 一下 没想到 环境 好 服务 好 宝贝 放在 沙发 睡 休息 一下 茶 挺 好 没想到 便宜 价位 好 地方 	__label__0
十分 不错 已经 娃儿 好 	__label__0
喜欢 口味 好 	__label__0
米线 一股 酸 臭味 牛肉 真是 一口 吃 打开 盖子 闻到 	__label__1
态度 好   服务 好   做 蛋糕 不错 	__label__0
两个 人去 吃 一个 代金 劵 位置 比较 好找 开餐 环境 好 做 中间 节目 表演 节目 少 点 服务员 好 热心   弄 照片 耽误 十几分钟 回来 发现 桌子 菜 全 服务员 收拾 说 有点 不好意思 开 一桌 爬 爬 虾 排队 人 真的 排 几次 吃 哈根达斯 真的 不错 希望 店家 优惠活动 好 	__label__0
味道 不错 服务态度 不错 环境 	__label__0
第一次 儿子 试 香蕉 优格 味道 挺不错 以后 继续 光顾 棒 	__label__0
北方 人 真的 吃 不惯 南方 面食 豆浆 行 包子 粥 好吃 全 扔 	__label__0
知道 第几次 这次 两个 朋友 四人餐 分量 很足 味道 依旧 好 	__label__0
本来 喜欢 吃 吃 一根 头发 呵呵 	__label__0
挺 好 菜品 新鲜 态度 好 味道 不错 	__label__0
吃 苍蝇 鱼香肉丝 套餐 	__label__1
一如既往 好   去过 几次   老人 小孩 满意 	__label__0
服务 特别 好 菜品 干净 一个 星期 吃 两次 拉肚子 特别 棒 	__label__0
不错 划算 强烈推荐 两次 	__label__0
菜品 精致 正宗 虾子 干净 大个 良心 商家 	__label__0
推荐 卤肉饭 味道 好 美团 优惠 	__label__0
三个 人 吃 分量 很足 味道 挺 好 	__label__0
服务员 态度 太好了 儿子 说 32 个赞 牛排 好吃 环境 好 家人 朋友 聚餐 好 地方 值得 推荐 	__label__0
好吃 很香 味道 纯正 不错 性价比 太高 值得 推荐 	__label__0
一直 喜欢 吃 味道 一直 好 	__label__0
价格合理 老板 细心 周到 下次 	__label__0
量 死 少 感觉 不值 50 	__label__0
订 生日蛋糕 味道 好 售货员 态度 好 好评 	__label__0
好 好吃 茶餐厅 强烈推荐 服务 好 	__label__0
鱼 新鲜 美蛙 好吃 菜品 不错 	__label__0
一如既往 好 品相 好 价廉物美 	__label__0
买 筒子 骨     真的 遭 不住   买 绿豆 送来 豆芽     补送 现在 都还没 送来   害 还要 走 店去 买 筒子 骨   钱 浪费 	__label__1
味道 不错 连锁店 	__label__0
喜欢 好吃 分量 足 	__label__0
好吃 好吃 菜品 新鲜 下次 还会来 	__label__0
好吃 便宜 	__label__0
儿子 沙坪坝 吃 儿子 完课 一点 点 金柏然 同款 人 套餐 吃 儿子 特别 喜欢 苹果 木肋眼 牛排 送 40 元 券 味道 好 超值 	__label__0
好吃 闺蜜来 最爱 抹 茶 老板 超好 免费送 大福 好吃 	__label__0
他家 团 味道 服务 不错 环境 一般般 	__label__0
菜 新鲜 肉 骗人 	__label__1
第一次 味道 真心 不错 太 好吃 环境 好 下次 一定 朋友 	__label__0
分量 少得 可怜 牛肉 里面 腊肉 算是 加餐 	__label__0
现在 拉肚子 	__label__1
吃 西瓜 拉肚子 坏 拿来 卖 	__label__1
喜欢 吃 牛蛙 面条 第二次 	__label__0
服务 好   菜品 新鲜   比较   周末 人 比较 	__label__0
味道 好 老板 态度 热情 环境 稍为 差 点 	__label__0
不错 四个 女生 吃 完 外地 同学 吃 反正 失望 	__label__0
阿姨 叔叔 热情 坐在 外面 晚上 灯会 暗 还好 味道 不错 朋友 吃 不惯 吃 人 凯里 酸 汤鱼 	__label__0
好吃 鸡排 比较 价格 实惠 	__label__0
吃 好 几次   不错 	__label__0
emmmmm 外地 刚过来 知道 说 感觉 一股 香精 味 糖太多 一点 好喝 巨 难受 	__label__0
牛排 问道 香 嫩 环境 舒服 弹钢琴 呵呵 服务 热情 喜欢 下次 还来 	__label__0
严重 差评 19 01 配送 四十分钟 拿到 主动 打电话 询问 商家 联系 配送 员 好 几次 电话 久 拿到 食物 早已 凉透 实在 太差 	__label__0
幽雅 环境 小而 精致 适合 约会 朋友 小聚 不错 朋友 下午 六点半 下班 就餐 人 后面 越来越 店家 坐满 人 人座 楼 吧台 座位 服务到位 亲切 温暖 菜品 精致 味道 惊艳 机会 还会来 	__label__0
  味道   价钱 不贵   分量 毛肚 有点 少     团购 菜品 总体 满意 	__label__0
吃 肚子疼   拉肚子   	__label__1
好吃 吃 吃 不厌 配菜 好吃 炒菜 干锅 好吃 最 喜欢 店 	__label__0
一只 酸奶 牛 人气 太高 每次 排好长 队 喜欢 吃 里面 紫米 总体 不错 酸奶 纯度 高 味道 好 重庆 分店 特别 知名度 大小 不容 小觑 美团 团购 实体店 买 便宜 点 挺 划算 	__label__0
慢 饿死 送来 电话 不通 	__label__0
味道 一如既往 好吃 分量 一如既往 地足 好 满意 	__label__0
味道 好 服务 环境 差 一点 	__label__0
挺好吃 分量 挺   下次 还会 	__label__0
配送 速度 太慢 一个多 小时 送到 点杯 豆浆 冷 吸管 	__label__0
环境 挺不错 适合 朋友 小聚 之前 最好 预定 人 特别 晚 就要 等位 团 张 代金券 补 30 元 姐妹 聚会 有点 小 激动 找钱 发票 走 上菜 挺快 味道 偏辣 感觉 桌子 有点 小 总体 不错 	__label__0
好 味道 不错 真的 不错 好吃 惨 	__label__0
送 鬼 超 难吃 送错 	__label__0
非常感谢 店家 服务态度 好下 下雨 送来 非常感谢 	__label__0
一如既往 喜欢 贡茶 贡茶 招牌 最 好喝 	__label__0
口味 茶包 放 太久 太久 涩 老板 服务 好 	__label__0
鱼 吃 很嫩 好吃 	__label__0
味道 不错 四种 口味 配送 到家 价格 实惠 店家 服务 好 不出 地铁站 直接 送到 站口 节约 时间 金钱 赞 一个 下次 还来 	__label__0
味道 好 公司 分量 足 请 朋友 吃 满意 	__label__0
这家 烤鱼 味道 确实 不错 我刚 北京 回来 朋友 推荐 这家 店 吃 香 辣味 确实 鱼 新鲜 份量 很足 入味 建议 煮 一会儿 入味 慢慢 吃 配点 家 柠檬水 特注 柠檬水 免费 免费 洋芋 饭 吃 满足 很饱 去过 亲 试试 家 位置 有点 不好 找 王少龙 火锅店 楼上 	__label__0
一如既往 好   老板 特别 好 以后 会常去 	__label__0
味道 好 中午 人 少 菜 新鲜 好 	__label__0
好 不错 环境 吃 	__label__0
地方 好找 装修 不错 味道 不错 外面 路边摊 煤炭 味道 	__label__0
  美团 态度   上菜 很快   米线 味道 好 一股 药膳 味道   味道 很浓   合胃口   汤 很浓 好喝   米线 弹性   肉 猪肝 分量 很足   一个 煎蛋   米线 下面 海带 豆芽   一个 蘸 碗   加 香菜 葱 调料 满意 一次 米线 	__label__0
顾客 三峡 广场 吃 芒果 卷 	__label__0
分量 足 不错 	__label__0
知道 第几次 x2 一如既往 继续 支持 	__label__0
不错 买 味道 卖相 好 	__label__0
地道 重庆 味   位置 比较 难 找   服务 热情   送 些 粽子 	__label__0
吃 味道 不错 	__label__0
一如既往 经济 实惠 味道 不错 	__label__0
知道 第几次 老板 人 好 味道 不错 物美价廉 	__label__0
食物 全 馊 好 恶心 商家 	__label__1
味道 很快 少冰 好喝 	__label__0
经济 实惠 蛋糕 新鲜 美味 好吃 希望 推出 类型 团购 	__label__0
配送 挺快 饭里 吃 钢丝 还好 看到 恶心 老板 发了 图片 没回 	__label__1
不错 美味 我們 工作 歺 吃 	__label__0
环境 温馨 简洁 菜品 摆盘 口感 挺不错 推荐 人 一起 	__label__0
好吃 牛肉 入味 老板娘 热情 	__label__0
位置 好找 老板 热情 菜品 味道 不错 环境 干净 适合 家庭 聚会 	__label__0
闺蜜 吃 平时 不吃 生鱼片 吃 说 好吃 	__label__0
不错 味道 ......... 	__label__0
卡布 其诺 赞 环境 挺 小资 每个 店员 热情 下次 一定 还会来 	__label__0
鸡肉 味道 知道 卖 汉堡 是不是 外边 放 久 卖 	__label__1
味道 正宗   好喝   服务态度 好 	__label__0
聚会 请客 吃 每个 月 几次 这次 家里人 吃 团 一个 遇到 下 大雨 飞虫 换 一桌 重新 换 一个 锅底 开心 影响 吃 东西 心情 要求 团购 菜 重新 贪小便宜 过来 解决 人 态度 觉得 不爽 做生意 第一年 情况 没得 处理 肯定 服务 完善 过来 处理 事情 人 口气 好像 无关 最后 过来 解决 人 态度 行 原谅 做生意 容易 	__label__0
好吃 味道 不错 想 吃 卤菜 时 买 	__label__0
份量 有点 少 估计 优惠券 变少 美团 一张 15 元 券 原价 30 多元 点 有点 坑 原本 想 吃 辣 选项 忘记 备注 	__label__0
划算 好评 	__label__0
味道 不错 稍微 辣 点 	__label__0
一只 酸奶 牛 味道 好极了 特别 热天 喝 一个 字爽 	__label__0
不错 好吃 吃 好 	__label__0
东西 好吃 nbsp 价格 死贵 商家 坑人 nbsp 退款 不让 nbsp 这家 店 	__label__0
味道 不错 位置 好找 忘 拍照 	__label__0
不错 吃 很饱 菜品 很棒 分量 足 干净 卫生 生意 好 喜欢 朋友 吃 吃 新店 错过 老板 人 挺棒 	__label__0
老板 态度 不错 买 两份 味道 不错 	__label__0
东西 打到 还要 说 问题 人 吃 态度 不好 以后 再也不会 点 这家 饿死 	__label__0
稀饭 冷 抄 手里 有虫 卤鸡 蛋 外皮 硬 嚼 不动 饺子 已经 不想 打开 	__label__1
流 一半 港式 奶茶 	__label__0
味道 还好 一楼 待客 服务 周到 下次 用餐 选择 	__label__0
美团 优惠 味道 不错 	__label__0
不错呀 面包 好吃 野 	__label__0
总体 不错 喜欢 	__label__0
味道 一如既往 好 一个 顾客 必点 招牌 酸菜 肉丝 米线   招牌 酸菜 肉丝 米线 面 	__label__0
味道 好 吃 挺 配菜 一定 每次 	__label__0
这家 烤鸭店 再也 吃 大部分 烤鸭 冷冰冰 油腻腻 吃 胃 难受 这家 一直 满意 价格 实惠 以后 继续 光顾 环境 好 服务态度 不错 满意 	__label__0
好吃     味道 很巴适 	__label__0
好 长期 这家 吃 味道 好极了 	__label__0
环境 不错 分量 足 一家 三口 吃 完 	__label__0
口味 挺 好 五分 	__label__0
土豆 馊 夏天 尤其 应该 注意 差评 差评 	__label__1
代金券 划算 菜 比较 丰富 新鲜 	__label__0
一只 酸奶 牛 顾客 现在 磁器 口 喝到 观音桥 第一家 店开 现在 随处可见 生意 真的 越做越 价格 越来越 贵 呜呜 呜呜 加冰 紫米露 真的 舒服 一口气 喝下去 好爽 紫米少 些 	__label__0
这是 第二次 团购 这家 汤锅 第一次 感觉 不错 第二次 继续 回购 位置 依旧 好找 熟悉 南坪 人 来说 轻车熟路 不太 了解 问 一下 位置 挺 当道 好找 吃腻 火锅 吃 一次 汤锅 舒服 一次 吃 腊 排骨 里面 配菜 藕 玉米 两个 人去 吃 剩下 菜 排骨 挺 汤 真的 好喝 两个 人 吃 饱饱 团购 价格 真的 实惠 建议 吃 人 选择 红椒 拌料 青椒 味道 偏辣 值得一提的是 红椒 真的 好吃 下饭 建议 商家 推出 团购 套餐 	__label__0
分量 足 味道 不错 环境 挺 好 	__label__0
第一次 评价 点 这家 图片 价位 吸引 人 吃 完 没事干 来个 具体 建议 真的 好吃 包装 纸盒 一股 l 浓烈 酸 臭味 餐饮 密封 装 不用 港式 套餐 奥尔良 外卖 员 路上 吃 米饭 夹生 味道 真的 不好 nbsp 吃 nbsp ps nbsp 好 后悔 认真 评价 	__label__1
披萨 真的 寸     小学生 	__label__0
点 东西 少 烤 鸭心 反正 看到 	__label__0
菜品 不算 新鲜 麻辣 牛肉 吃 有点 沙哈 不错 饮料 不错 不像 自助餐 整些 杂牌 饮料 这家 矿泉水 走 高端 很赞 底料 口感 有待于 提升 觉得 有点咸 听到 隔壁 桌 说 咸 服务态度 特别 好 特别 瘦瘦的 小妹 特别 勤快 帮 兑 奶粉 长得 可爱 	__label__0
送 外卖 放到 地下 态度 放 走 	__label__0
水果 蛋糕 好 喜欢 	__label__0
情况 辣椒 辣 第一次 吃 辣 东西 本来 吃 辣 这次 鱼 吃 辣 一把 鼻涕 一把 泪 辣椒 问题 朋友 	__label__0
味道 挺 特色   好 推荐 	__label__0
好吃   有味   顾客   以后 玫瑰 诱惑   午餐肉   广式 香肠 	__label__0
之前 朋友 感觉 不错 次来 	__label__0
好吃 每次 好 朋友 吃 味道 真的 很棒 服务态度 很棒 杨家坪 家 好吃 哈哈哈 下次 还来 	__label__0
回头客 菜品 不错 价格 优惠 菜品 丰富 	__label__0
菜 含 盐巴 钱 	__label__0
喝 老板 很熟 万达 周边 独爱 这家 	__label__0
口味 不错 性 比价 高 特别 划算 	__label__0
最 喜欢 吃 划算 不错 以后 买 	__label__0
强烈推荐 位子 好找 菜品 丰富 新鲜 	__label__0
吃 小 蚊子 昨天 室友 吃 小 蚊子 有图 为证 	__label__1
真是 物美价廉 菜品 丰富 满意 	__label__0
味道 好 服务 好 环境 不错 	__label__0
味道 辣 说 孕妇 菜 烤熟 一点 说 不行 以后 点 	__label__0
不错 价格 还好 还会来 老板 热情 	__label__0
购买 味道 好 服务 单位 团年 	__label__0
速度 太慢 送到 饿死 	__label__0
套餐 介绍 说 口味 两个 手卷 切开 感觉 死 欺骗 人 	__label__0
鱿鱼 根本 办法 吃 水泡 看起 恶心 鲜虾 堡 里面 夹 菜 黑 骑手 态度 差 骂人 找 不到 地方 说 没住 找 得到 吃个 外卖 气 吃饱 	__label__1
价格 适中 味道 家买 好多 蛋糕 团购 款式 试过 蓝莓 芒果 好吃 	__label__0
姐姐 温柔 炒 酸奶 好吃 里面 葡萄干 红豆 黑芝麻 蓝莓 酱 ..... 	__label__0
难吃 特马 贵 虾 不鲜 肉质 超级 差 一碗 米饭 碗 小 倒 装满 	__label__0
菜品 新鲜 感觉 前一天 剩下     位置 好找 喜欢 汤圆 洋芋 饭 	__label__0
好吃 女朋友 重庆 玩 服务 特色 解放前 风格 生意 好 排 好 长队 味道 不错 	__label__0
红烧 牛肉 煲仔饭 真 难吃 	__label__0
挺好吃 下次 光顾   蛋糕 胚 	__label__0
服务 好 鸡排 好吃 	__label__0
吃 家 这种 长虫 材料 做 粥 飘 面上 一只 以为 家   越 吃 越   知道 粥 问题       以后 不敢 点 接近 30 一碗 粥   卫生 保证 够 	__label__1
超级 难吃 土豆 炸 煮 一点 新鲜 菜 种类 感觉 食材 新鲜 	__label__0
老板 人 好 好吃 再 	__label__0
第二次 买 这次 团购 便宜 好多 介绍 朋友 老板 美女 	__label__0
送个 面条 一个 小时 醉 面块 溶   吃 太油 太油     味道 难以 下咽 半个 小时 商家 打电话 问 送过来     凶   说   煮   问   算了     哈子 态度   后面 二十多分钟   人 饿死   打电话 过去   却 关机       呵呵 垃圾     面 送到   盖子 上面 全部 别个 点 番茄 油水     恶心     垃圾   再也 这家 吃 	__label__0
服务 周到 态度 客气 味道 不错 	__label__0
值得 推荐 餐厅 味道 好 人气 旺 服务 一流 二楼 一楼 爆满 还好 预约 	__label__0
实惠 菜太少 太贵 	__label__0
吃 好吃 吃 完 晚上 舒服 想要 吐 第二天 早上 直接 拉稀 	__label__1
味道 不错 环境 不错 位置 好找 	__label__0
中午 时间 紧 必吃 林妹妹 以前 非要 两 路口 现在 开 	__label__0
好 味道 一如既往 好 老板 生意兴隆 	__label__0
说 确实 分量 足 人餐 两男两女 吃不完   洪湖 藕 炖 盐排 小 	__label__0
差评 是因为 卫生   吃 地沟油 感觉 太 强烈 ....   果不其然 第二天 拉肚子 	__label__1
地瓜 火锅 味道 好 服务态度 好 菜品 新鲜 环境 	__label__0
好吃 一家 小店 鱼 味道 特别 好 老板 服务 热情 菜品 份量 足 套餐 四个 大人 一个 孩子 吃 吃 完 素菜 鱼 吃光 好吃 加 一份 豆花 一个 菜 吃 舒服 山上 好多 呵呵 赞 一个 太饿 拍 美食 光顾 吃 	__label__0
鸡块 没熟 好吃 全 扔 黄金 鸡块 	__label__1
量少   速度慢   换 菜 说 一声 	__label__0
有点 不好 找 巷子 二楼 店铺 装修 小 清新 音乐 环境 适合 一两个 人 听听 音乐 上上网 聊聊天 喝 喝茶 惬意 老板 一家人 不错 特意 现做 吃 太 感动 醪糟 汤 好喝 能续 杯 油茶 比较 味 送 一张 照片 	__label__0
我点 米线     煮 土豆粉 	__label__0
服务 好 递给 力 性价比 高 	__label__0
味道 不错 位置 好找 	__label__0
味道 好 上菜 速度 比较 	__label__0
服务态度 	__label__0
不错 老板 人 挺 好 小鱼 好萌 	__label__0
买 八人 套餐   划算 菜量 很足 八个 人 吃 完 包 沾 酱 超 好吃 菜 好吃 汤 香 店面 位置 好 说 美团 八人 套餐 直接 找 位置 坐下 上菜 服务 超棒 态度 赞 一起 朋友 说 下次 再 帮 很棒 地方 强烈推荐 	__label__0
肉 今天 好 难吃 	__label__1
哈哈哈   刨 酸奶 太 好吃 好评 好评 	__label__0
一直 喜欢 每味 每客 	__label__0
总体 来说 价格 不错 觉得 饮料 好 加多宝 国宾 随便 喝 菜 增加 一点点 	__label__0
东西 送少 太差 服务 差 东西 差 快递 差 难吃 死 一股 恶臭 丢 丢 ..... 	__label__1
味道 好 价格 实惠 以后 还会 再 	__label__0
不错 酸辣粉 好吃 味道 正中 鸡排 好吃 奶茶 感觉 味道 不够 浓郁 	__label__0
时间 一个 小时 二十分钟 	__label__0
说句实话 量 一锅芋 儿鸡 一只 鸡 三分之一 味道 好 可惜 辣 一点 服务 不错 	__label__0
老板 态度 好 羊肉 粉 味道 不错 	__label__0
一吃 晓得 菜 味道 盐 煎肉 肥得 明目张胆 白菜 藕 生 人 吃 	__label__1
12.26 下单   13.56 送达   速度   亏 天气 热   冬天 油 凝结 	__label__0
理工 门口 好 几次 	__label__0
鬼 东西 贵 好吃 排骨 几块 汤 藕 藕 	__label__0
不错 长期 顾客 哈哈哈 	__label__0
最慢 最 差劲 收 三块 钱 那种 盒子 装 炒面 八九块 那种 还标 十六块 对得起 价钱 一次 鬼 不敢 打下 一次 	__label__0
菜品 新鲜 干净 服务员 态度 好 有点 懦弱 允许 客人 牵狗 进店 吃饭 弄 狗 毛 满天飞 食欲 匆忙 离席 	__label__0
打开 一个 蚊子 无 语 	__label__1
吃 一个 星期 要来 吃 次 女性朋友 带来 一起 再来 说 些须 经典语录 说 是不是 觉得 心 人生目标 生活 方式 生活 方式 就要 是不是 	__label__0
吃 一只 苍蝇 想 算了吧 继续 吃 一共 吃出 只 补 蛋白质 不应 	__label__1
妈卖批 牙签 吃 锤子 螺丝 	__label__0
东西 送 外面 态度 极差 鸡肉 卷里 头发 搞 胃口 再也不会 这家 店 吃 东西 垃圾 	__label__1
好吃 咖喱 正宗 想 吐 味道 	__label__0
知道 说 好 包装袋 打开 有股 蟑螂 味 吃 	__label__1
最 爱 绿豆 紫米露 买 好 烈日 下 跑 买 挺 拼 」 ∠ 	__label__0
方面 好 太热 老板 说人少 不开 空调 太热 吃个 饭 洗 澡 	__label__0
死 虾 没敢 吃 唯一 好 一点 花甲 洗 干净 	__label__1
菜品 丰富 新鲜 吃 好 每次 吃 自助 这家 真心 好吃 赞 一个 	__label__0
味道 好吃 上菜 速度 	__label__0
  比较 喜欢 偏甜   熊猫 奶盖   抹 茶 奶盖 不错 	__label__0
味道 真的 不错 宴请 亲朋好友 地方 还会 再 	__label__0
味道 好 上菜 环境 位置 好找 	__label__0
汤 不错 青椒 炒 玉米 玉米 炒 太 特别 难吃 麻辣 鸡 鸡肉 贴近 骨头 部分 生 血 	__label__1
下午茶 人少 环境 不错 	__label__0
第一次 点餐 好吃 味道 越来越 不好 	__label__0
菜品 新鲜 口感 不错 环境 优雅 	__label__0
味道 不错 10 刚刚 好 下次 还会来 	__label__0
划算     妈妈 两个 人 吃 很饱 	__label__0
来过 几次   味道 不错   服务员 热情   团购   c 依然 态度 好   分量 足     环境   卡座   卫生 好 	__label__0
阿兴记 环境 名声在外 不用 点评 团购 后 价廉物美 宴请 接待 好 地方 	__label__0
菜品 不错 环境 还好 服务 不错 总 	__label__0
服务态度 超级 好 点多 鱼 分量 好大 两个 人 两个 菜 够 	__label__0
第二次 店里 吃 披萨 这次 吃 水果 披萨 口味 感觉 不错 吃 完 发现 照片 水果 量 芝士 喜欢 黄桃 小吃 一如既往 好吃 鱿鱼 圈 薯条 喜欢 这次 没想到 老板 认识 真是 一位 有心 老板 无论是 美食 店里 环境 服务 值得 再 一次 消费 	__label__0
环境 口味 不错 下次 家 消费 	__label__0
老公 重庆 工作 生日 美团 订购 老公 反应 说 味道 好极了 外观 很漂亮 最 重要 及时 送到 真心 不错 	__label__0
一如既往 好 吃 好 几次 真心 不错 	__label__0
不可 以上 图   大个 虫 吃 最后 发现   毒死   做 餐饮 重要 干净 卫生 以后 再也 不敢 吃 你家 现在 看到 想 吐   不知 吃 虫 	__label__1
酸奶 味道 一直 好 值得 推荐 	__label__0
服务 超级 棒 ω ＼ 服务员 好 可爱 吃 不错   毛肚   刘 一手 香 豆腐 	__label__0
味道 好吃 特别 椒 麻 值得 推荐 家人 聚餐 已经 第三次 味道 一次 一次 好 请 亲朋好友 一起 组队 吃 鱼 	__label__0
一如既往 好吃 还会 再 	__label__0
味道 挺 好 吃 辣 剩 	__label__0
饭 	__label__1
好吃 买来 吃 继续 保持 味道 	__label__0
好   阿姨 好     菜 	__label__0
一个 字 好 二个 字 好 三个 字 好 服务 好 菜品 新鲜 大力 推荐 尝尝 11 人才 600 多元 太 划算 	__label__0
已经 态度 超级 好 香 辣味 很棒 	__label__0
猪蹄   再也不会 买 	__label__1
油弄 100 块钱 买 一点点 分量 超级 小 骗人 	__label__0
的哥 外卖 送 小时 40 分钟 昨晚 吃饭 饿死 筷子 	__label__0
环境 干净 味道 很巴适 值得 享用 	__label__0
包装 越来越 好     服务 周到     下次 还来 	__label__0
越来越 差 手套 送 奶茶 冷 热 差评 	__label__0
顾客 好吃 以后 走 吃 	__label__0
好喝   常温 冷 	__label__0
空心菜   知道 昨天 是不是 空心菜 原因 害得 早上 呕吐 现象 拉肚子 卫生 宽粉 煮 散 	__label__1
鱼 申请 退款 	__label__1
味道 不错 值得 推荐 好吃 吃得出 重庆 味道 	__label__0
价格便宜 菜品 新鲜 份量 足够 	__label__0
上菜 速度 态度 好 热情 菜品 味道 正宗 	__label__0
创业 容易 支持 一下 东西 不错 服务态度 好 约 取 蛋糕 地点 送 下来 送到 轻轨站 回去 感动 蛋糕 新鲜 朋友 喜欢 蛋糕 味道 不错 喜欢 希望 老板 以后 再接再厉 做 更好 漂亮 蛋糕 寸 蛋糕 	__label__0
太硬 嚼 嚼 不动   皮鞋 样 吃   买 一次 两次 这次 最 难吃   备注 葱 指 两个 葱   气死 	__label__0
上菜 菜品 真的 好吃 特别 适合 重 口味 人 	__label__0
味道 不错 分量 环境 比较 好 服务 好 下次 还会 光顾 	__label__0
这次 吃 质量 不太好 吃 拉肚子 	__label__1
差评 说 两遍 加热 希望 送来 热 送来 温 冬天 油腻 菜 吃 拉肚子 害 加热 一下 味精 味 同样 重 	__label__0
味道 好 量 足 吃 完全 够 	__label__0
蛋仔超 好吃     口感 不干 不腻     有颜 有料     值得 推荐 	__label__0
速度 太慢 一个 小时 态度 好 	__label__0
好 游客 麻又辣 特别 香 知道 地方 吃 假 火锅 	__label__0
说 少加 辣椒 很辣 	__label__0
不错   家里 预约     老板 已经 菜 好     直接 坐下 煮 一会 吃   味道 不错   汤 好喝   看看 江景   经济 实惠 	__label__0
我点 五花肉 一点 盐都 肉 	__label__1
吃 味道 不错 服务态度 超级 好 经济 实惠 回来 团 68 吃 好胀 	__label__0
好吃   蒜 香味   虾子 新鲜   冰冻 虾   	__label__1
吃 拉肚子 无 语 	__label__1
吃 人 挺 分量 四人 吃 完全 吃不完 浪费 好多 	__label__0
整体 不错 服务 好 不用 上菜 一次 二人 餐 两个 人 使劲 吃 吃 完 一次 三人餐 吃 撑 吃 很饱 吃 完 蘸 酱 好吃 觉得 面皮 湛江 加 烤鸭 绝配 汤锅 喜欢 麻辣 竹笋 面皮 不错 好评 前 两张 三人餐 后 两张 两人餐 	__label__0
真的 难吃     确实 难吃 办法 	__label__0
老板 人超 超好   味道 超好 	__label__0
不错 价廉物美 比想 好 以后 还会 再 	__label__0
不错 甜品 好吃 鳗鱼 饭 好吃 	__label__0
味道 不错 服务 好 已经 	__label__0
下次 再也 不想 买 	__label__0
不错 吃 好多 回 一如既往 好 离家 小区 门口 走 几步 店家 态度 好 团购 歧视 吃饭 前 消毒 热 毛巾 擦 脸 擦 手 态度 相当 好 满意 免费 玉米 羹 醪糟 汤圆 吃 值得 推荐 	__label__0
这家 店 装潢 风格 独特 服务员 穿着 偏 民族 服饰 男朋友 维族 人 四川 几年 这次 一起 过来 偶然 看到 店 说 太 正宗 特别 好吃 赞不绝口 性 比价 特别 好 服务态度 特别 好 新疆 啤酒 很赞 吃 几口 说 下次 小 长假 还要 吃 这次 吃 抓饭 下次 补 	__label__0
饭太少 一碗 饭 几口 吃 完 	__label__0
再 江苏 喝德 今天 点 原味 奶盖 红茶 半糖 冰 味道 江苏 茶少点 奶盖 多点 奶盖 洒 点 抹 茶粉 这满 不错 适合 口味 一大 杯量 足 够 两个 人 喝德 奶盖 拌 均匀 好喝 腻味 	__label__0
这次 送 披萨 蛋挞 呵呵 	__label__0
味道 不错 我家 五花肉 不错 	__label__0
味道 好 服务态度 好 下次 再 	__label__0
味道 不错 真心 再放 芝麻酱 重庆 人 吃 	__label__0
不错 去过 几次 开业 最好 	__label__0
吃   强烈推荐     金针菇   豆皮   方便面 虾饺 组合 	__label__0
送 两个 小时 说 这家 买 酌情 考虑 	__label__0
猕猴桃 变质   很软 注意   吃 很大 酒味   今天 吃 很大 酒味   以前 超市 买   呵呵 百度 一查 变质   吃 人体 特别 不好   店 好意思 卖 出门 路过 你家 店 再 买 水果   良心   孕妇   呵呵   确实 	__label__1
方便面 没熟 没法 吃 竹笋 咬 不动 菜品 	__label__1
超级 难吃 咸 鱼 难吃 要死 再也 这是 第一次 	__label__0
好吃 价格 贵 份量 少 一家 口人 平均 一人 100 元才够 	__label__0
味道 好     大理 酸奶 好喝 	__label__0
味道 不错 上菜 分量 十足 服务员 态度 很差 需要 提高 服务质量 	__label__0
环境 还好 味道 好 服务 好 价格 贵 	__label__0
不错 团 好 还会 	__label__0
味道 好 便宜 环境 32 赞 	__label__0
菜品 新鲜 值得 一去 	__label__0
鸭肠 坏   拉 晚上 	__label__1
份量 少 好多 55 元 菜 不够 吃 家 吃 N 次 这次 少 	__label__0
顾客 吃 几十回 服务 习惯 	__label__0
味道 不错 分量 足   本来 三个 人 吃 想团 四人餐 看到 评论 说 三个 人 吃 两人餐 足够 团四人 想着 不够 再点 吃 完 老板 说 鱼 整条 两斤 良心 商家 	__label__0
味道 好 种类 多样 不错 	__label__0
送货 速度 很快 服务态度 好 芒果 千层 好 好吃 说 一点 不腻 性价比 高 赞赞赞 迫不及待 评价 	__label__0
服务 好 到位 老板 人 不错 好吃 过瘾 下次 还要 	__label__0
莴笋 头   鲜 毛肚   红汤 锅底   南瓜饼   手工 肉片   珺 花   黄瓜 条 	__label__0
上午 10 点 过去 黑米 家 服务 小哥 正在 准备 食材 准备 开工 前面 已经 几个 人 还好 两分钟 正式 做 手卷 做 过程 看着 干净 卫生 很快 手卷 拿到 开 吃 木有 拍照 味道 真心 好 人来 回头客 32 个赞 ≧ ▽ ≦ 	__label__0
吃 以后 感觉 不错 分量 比较 吃 吃 完 剩 比较 经济 便宜 实惠 	__label__0
鬼 蛋 这是 炒饭 	__label__0
今天 店家 心情 不好 	__label__0
不错 挺 味道 不错 	__label__0
环境 好   服务态度 好   菜品 丰富   味道 不错 商务 餐 好去处 赞 一个 	__label__0
评价 迟 蛋糕 好吃 店 里面 看到 师傅 做 做 很快 	__label__0
我点 宫保鸡 丁 确定 鸡丁 全是 肉丝 宫保鸡 丁 知道 说 欺骗 人 	__label__0
想 吐 银耳汤 杯盖 上面 一颗 老鼠屎 黏在 上面 	__label__1
一如既往 好 10 次 每次 感觉 每次 吃 黑椒 意大利 面 好吃 	__label__0
菜品 不错 不错 感觉 点点 小贵 嘿嘿 服务态度 不错 	__label__0
菜品 特色 环境 不错 味道 特别 吊 烧鸡 传奇 牛肉 好吃 下次 还来 	__label__0
只 只 酸奶 牛 酸奶 馊 	__label__1
最最 糟糕 一次 外卖 糟糕 食品 全部 死 估计 明天 拉肚子 知道 冻 多久 反正 再也不会 点 他家 老板 做 食品 生意 食材 真的 重要 做 挎 掉 蒜蓉 生 蚝 ## 蒜蓉 大元贝 赠 ## 香辣 小龙虾 	__label__1
可乐 鸡肉 卷 知道 可乐 跑 	__label__0
好吃 好吃   最 喜欢 吃 这家 盐 酥 鸡 骨鸡排 	__label__0
太干 不润 丝 正宗 	__label__0
稀饭 炖 好吃 不香 饭 糯 值得 价钱 	__label__0
三个 小时 吃 饭 难受 	__label__0
太咸 饭 凉 太 难吃 	__label__0
去过 几次 味道 服务 满意 在家 附近 会常来 	__label__0
超过 预计 时间 一个 小时 	__label__0
环境 不错 上菜 比较 菜 分量 三个 人 吃 吃 撑 汤 味道 好 一锅 汤加 几次 喝完 强烈推荐 自助 水果 饮料 服务员 态度 赞 一个 一点 团购 不好 美女 很漂亮 	__label__0
总体 来说 不错 牛肉 精到 口感 	__label__0
应该 喜欢 重庆 口味 	__label__0
尖椒 兔套 饭 肉 	__label__1
生日 老公 买 超级 好吃 吃 最 好吃 蛋糕 水果 新鲜 	__label__0
商家 服务态度 好 下次 还会 再   红汤 锅底   绿色 毛肚   鲜鸭肠   油碟 	__label__0
	__label__0
菜品 不错 分量 足 完全 吃不完 	__label__0
分量 很小   卖得 偏贵   感觉 东西 卫生   第二天 拉肚子 吃 	__label__0
差评 我要 部分 微辣 减 全部 减成 一盒 真的 黑 冒火 	__label__0
蛋糕 好 可爱 蛋糕 味道 不错 上面 水果 看着 漂亮 猕猴桃 生 浪费 商家 换成 买 面包 好吃 下次 	__label__0
里脊肉 吃 股 味道 应该 新鲜 店里 买 相信 店里 食材 新鲜   以为 网上 买 欺骗 消费者 藕片 放 久 以往 相比     食材 越来越 新鲜   吃 拉肚子 一味 钱   对待 消费者 	__label__1
14 块 饭少 加点 杂碎 随便 抄抄 	__label__0
青椒 炒熟 肉量 不像 炒 像是 煮 一份 小炒 肉全 生 青椒 吃 	__label__0
选 一种 辣 老板 服务态度 相当 好 	__label__0
态度 还好 菜品 少 ❤ ️ 总体 行 	__label__0
不错 服务态度 十分满意 下次 聚会 年终 聚会 还来 	__label__0
全是 豆芽 肉 	__label__0
真是 难吃 路边摊 	__label__0
味道 不错 环境 服务 还好 不错 	__label__0
顾客 没什么 好 挑剔 	__label__0
难吃 	__label__0
送过来 冷 吃 	__label__0
味道 好   服务 好   便宜 哈哈哈 好 	__label__0
夏天 吃 上火 味道 好 物美价廉 	__label__0
椒盐 皮皮虾 没肉 咸 发苦 巨咸 无比 吃 一只 剩下 全部 浪费 香辣 耗儿 鱼 一个 字 咸 特别 干 鱼 干 反正 超级 难吃 	__label__0
送 半天 量 太少 好吃 	__label__0
第一次 有点 失望 荤 臭味 	__label__1
每次 这家 父母 觉得 不错 图 	__label__0
吃光 味道 好吃 下次 买个 大份 	__label__0
虫子 好 恶心 清洁卫生 怎么回事 太 地道 工商局 事 商家 看到 请 联系 气愤 	__label__1
味道 不错 分量 足 送 份 凉面 好评 	__label__0
一如既往 地好 好吃 好吃 美味 美味 	__label__0
味道 好 喜欢 原味 服务 欢迎 尝试 	__label__0
放心 吃 你家 	__label__0
上次 路过 吃 一次 服务 热情 好吃 这次 附近 逛街 特意 团 遇到 手机 电 关机 无法 验证 商家 先 煮 面 体贴 周到 光顾 	__label__0
不错 汤头 好喝 蘸 酱 好吃 搭配 好吃 不错 	__label__0
好喝 每周 喝 两次 	__label__0
馊 卖 缺德 	__label__0
味道 差 要死 几块 鸡 香味 吃 拉肚子 再 买 	__label__1
  味道 不错   值得 一试 	__label__0
顾客 好吃 火锅 尤其 鳕鱼 	__label__0
喜欢 吃 味道 一直 不错 	__label__0
服务 好   焦糖 布丁 好吃   奶茶 好喝   下次 继续 吃 	__label__0
服务 菜 味道 不错 份量 有点 少 	__label__0
老板 请 告诉 确定 这是 3.5 斤 鱼 严重 参假 鱼 看不到 全是 菜 气 	__label__0
太 难吃 戚风 蛋糕 一两 元 蛋糕 椰蓉 蛋糕 干瘪 放 N 天 黄金 片 硬 咬 掉牙 好评 刷 	__label__0
奶茶 苦 好喝 	__label__0
一个 吃货 来说 估计 吃 最 难吃 烧烤 最 重要 下单 后过 七分钟 点 退货 老板 打电话 说 已经 烤 好 拒绝 退款 尼玛 菜品 烤 再 扮 佐料 打包 七分钟 够 五十分钟 送来 七分钟 烤 好 送个 餐要 五十分钟 不远 果断 差评 难吃 点 这家 烧烤 需 慎重 	__label__0
不错 今天 多收 餐费 打电话 退还给 口感 不错 下次 还来 	__label__0
味道 之前 吃 完全   换 老板   味道 好淡   时间 迟到 这么久 	__label__0
味道 好 分量 很足 锅巴 最香 	__label__0
联系 卖家 时 知道 汤 送 吃 外卖 没吃过 糟糕 炒饭 炒粉 股 臭味 不敢 吃 扔 正宗 沙县 食客 请 慎重 订餐 用美团 这么久 点 饭菜 合口味 好评 饭菜 忍 第一次 差评 	__label__1
服务员 小哥 态度 好 细心 棒棒 味道 不错 	__label__0
需要 加菜 	__label__0
吃 蟑螂 好 恶心 	__label__1
说 番茄酱   番茄酱   	__label__0
牛肉 扔 肉 里面 菜 再也不会 点 这家 	__label__0
没人接 配送 说 一声 n 电话 商家 没人接 一个半 小时 真是 呵呵 送来 粥 里面 蚊虫 包子 里面 锡箔纸 吃 差评 第一次 	__label__1
小面 味道 意外 不错 份量 足 	__label__0
好 很久 想 吃 铁锅 门 以前 读书 喜欢 吃 今天 正好 看到 终于 满足 一如既往 虾 很大 好吃 一百 一张 代金券 就够 	__label__0
环境 服务 菜品 满意 菜品 新鲜 店员 亲切 进门 听见 大声 迎宾 语 位置 好找 大融城 背后 星天 广场 楼 美食街 里面 中午 人 上菜 速度 很快 多久 好 味道 特别 好吃 	__label__0
吃 只 苍蝇 	__label__1
价格 合适 服务周到 吃 种类 几次 	__label__0
重庆 第二次 味道 很棒 价格 合理 推荐 	__label__0
第一 吃 铁板烧   量     两个 人 吃不完   辣椒 好 	__label__0
超级 好 食材 新鲜 服务 好 最 爱 海胆 牡丹 虾 	__label__0
吃 看到 饭 表面 虫 吃 	__label__1
味道 不错 老板 人 好 喜欢 吃 尝试 一下 	__label__0
好   老板 人 好 下午 猪脚 好吃 些 上午 入味 下午 棒棒 哒 	__label__0
每次 排队 	__label__0
第三 回去 这次 临时 决定 手机 团购 下午 六点 电话 预约 以为 等位 还好 位置 服务员 一如既往 热情 六人餐 六个 人 吃 满意 蛋炒饭 免费 脐橙 相当 好吃 醪糟 汤圆 不错 这次 唯一 缺憾 一盘 豆干 变味 估计 放得 有点 久 希望 商家 以后 注意 总体 值得 再 推荐 	__label__0
东西 真的 快递 不错 	__label__0
特别 卫生 吃 点 秘制 烤 翅 块 鸡腿 糊 在意 妹妹 说糊得 咬 不动 就让 扔 还点 一只 蜜汁 手扒鸡 送来 打开 妹妹 吃 打开 感觉 味道 怪怪的 扒 一只 鸡腿 臭味 散发 点 第一次 遇到 这种 情况 	__label__1
味道 棒   很甜 	__label__0
送个 外卖 小时 	__label__0
吃 最 难吃 开胃 粉 从没 点 难吃 东西 根本 吃不下 全 扔 	__label__0
开业 店 环境 好 紫米露 好 一杯 味道 不错 态度 特别 好 送 两张 元 优惠券 	__label__0
离住 地方 不远 鱼现 杀 新鲜 鱼 肥妹 老板 人 好 	__label__0
味道 极好 脆皮 足够 脆 不油 	__label__0
不错   车站   那家店   重百 店里   订 蛋糕   团购 划算 	__label__0
味道   服务 不错   下次 	__label__0
点 牛肉 串 根本 放在 一起 根本 看不出来 牛肉 串 放进去 真的 可怕 	__label__0
真的 超 好吃 想 吃 正宗 火锅 选 这家 没错 	__label__0
加饭 差评 ｀ Ω ´ v 	__label__0
味道 不错 好吃 以后 独特 	__label__0
白米饭 好吃 划算 一元 买 很大 一盒 水煮 肉片 先不说 口味 问题 大半碗 豆芽菜 肉片 吃 直接 叫水 煮 豆芽 好 名字 取 好听 图片 拍 漂亮 吸引 新 顾客 吃 一次 人 知道 这种 事实 还会 再 顾客 还会 做 餐饮 讲 良心 诚信 几点 根本 得人心 米饭 确实 好吃 便宜 觉得 卖家 有点 亏 水煮 肉片 赚 	__label__0
环境 不错 九十分钟 转 一圈 看到 整个 解放碑 全景 请 外地 朋友 吃饭 特别 合适 上菜 速度 味道 不错 水煮 牛肉 太肥 瘦点 好 特别 温馨 餐前 送 每人 一小 碗 红糖 冰粉 冰凉 爽口 谢谢 店家 挺 好 	__label__0
位置 挺 好找 门面 宽敞 环境 不错 干净 大气 我定 晚上 七点 位置 店里 人蛮 店家 预留 一桌 小 感动 排队 直接 上桌 上菜 速度 很快 菜品 丰富 份量 很足 水果 炒饭 好吃 好评 	__label__0
好吃 牛肉 比较 实惠 位置 不太好 找 强烈推荐 全 五分 	__label__0
一如既往 好喝   喜欢 放牛 斑   希望 多点 座位 	__label__0
菜品 种类   饮料 挺   烧烤 真的 很赞   喜欢 鸡瓜     真的 不错 	__label__0
点 三两 估计 最多 两 最 	__label__0
不想 说 难吃 吐 红烧 茄子 烧焦 一点 吃 放点 油 下锅 衮 一圈 弄 送到 已经 完全 冷 已经 无 语 只 想 说 一个 茄子 直接 抄 玩意 	__label__0
离家近 味道 不错 环境 好 下次 还会 再 光顾 	__label__0
服务 满意 	__label__0
比较 晚 菜 比较 少 早点儿 几次 总体 	__label__0
味道 不错 喝 商家 不错 	__label__0
吃 N 次 不错 	__label__0
毛豆 难吃 关键 说满 28 送 金猴 福袋 专门 点够 根本 送 呵呵 风味 骗人 	__label__0
第一次 好吃 鱿鱼 腥味 很大 价格 单子 说好 送加 多宝 	__label__0
味道 不错   老板娘 服务态度 好   亲和力   下次 吃 鸡 	__label__0
送来 放到 门口 电话 全部 冷   根本 没法 吃 真的 很差 	__label__0
快递 小哥 不错   电梯 上不来   爬楼梯 五楼 送到   真心 不错       外卖   重 没吃过 难吃 烧烤   一点 味   想 请问 店家   没钱买 盐 	__label__0
一个 人尝 一口 确认 真的 东西 难吃 逼 难吃 理解 卖 变质 东西 真的 忍 	__label__0
送得 太慢 送来 算是 冷 再点 这家 	__label__0
好吃 吐血 推荐 味道 极赞 汤汁 味道 浓厚 	__label__0
味道 不错 老板 人 多好 有点 远 及时 送到 	__label__0
吃   划算   味道 好   面 米饭 好吃 	__label__0
鸡腿 生 拉肚子 	__label__1
吃   每次 万象 城必点   特别 喜欢 它家 薯 霸王   地址   万象 城 b1 西西 书店 大门 看到   它家 生意 挺 好   人流量 挺 服务   自助 打印 团购 券   打印 小票 后 领餐   过多 服务   最好 团购 兑券处 安排 一个 人   好 方便 顾客 操作速度   打印 券后   小票 服务员 后 领餐   速度 蛮快 环境   肯德基 麦当劳 吃   喜欢 它家 环境 一些 现代 一些   小孩 纸和供 小孩 玩耍 器具 感觉 清净 一些 味道   团购 一个 薯 霸王 套餐   里面 包括 超打薯 霸王 一杯 气泡 水     超大 薯条 包装 两个 薯条 	__label__0
牛奶 送过来 有点 过分 	__label__1
好吃 味道 好 	__label__0
以前 金丝 酥 点 味道 不及 以前 赞 菜品 新鲜 还会 再 	__label__0
味道 不错 第二次 价格 偏贵 小 刘 服务 挺 好 热情 好评 	__label__0
老板 人 特别 好 点心 特别 好吃 每次 吃 好多 点心 	__label__0
老板 态度 好 价格 实惠 下次 再 	__label__0
刨 酸奶 一碗 吃饱 分量 足 	__label__0
味道 不错 经济 实惠 强烈推荐 	__label__0
味道 不错 分量 足       吃饭 环境 比较 舒适     适合 聚餐 	__label__0
朋友 一起 好 	__label__0
奶味 超足 小姐姐 小 哥哥 人 好 紫米 刚蒸 香喷喷 以后 吃 哒   包装 超 可爱 o 	__label__0
好喝 不错 新鲜 几次 	__label__0
可乐 送成 奶茶   热 	__label__0
味道 不错 锅有 一点 辣 东西 挺 小吃 好   nice 	__label__0
味道 好 鱼 新鲜 老公 喜欢 	__label__0
好   喜欢   再 	__label__0
肉多 份量 完全 吃不完 不错 地方 还好 找 	__label__0
完全 新鲜 千万别 吃 苍蝇 头发 	__label__1
吃 这家 服务 挺 好 菜品 时代 天街 音乐 声音 真心 关 小点 人 更好 就餐 环境 	__label__0
骗人 店 偷工减料 好少 菜 烂店 一个 烂 烂 烂 	__label__0
草莓 石头 发苦 西瓜 变质 桔子 酸苦 这种 水果 卖 醉 无良 商家 	__label__1
已经 吃 位置 好找 人多 菜品 换新快 新货 	__label__0
最差 一次 外卖 体验 好不好 吃 回事 点 荤 少素 套餐 全是 素菜 套餐 外 单点 脆皮 肠 鸡心 吃 完 看到 下午 两点 订单 饭点 高峰期 扯 忙 建议 以后 走 点心 	__label__0
平时 面包店 买 小 	__label__0
风格 特别 好 	__label__0
鱼香肉丝 很甜 很酸 	__label__0
点 两瓶 荔枝 爽 只 送 一瓶 可乐     牛肉 点 两次 没得 	__label__0
满意 还会 再 	__label__0
分量 太少 撒 	__label__0
味道 好 第二次 烤鱼 外卖 回头客 食材 烤鱼 缩水 相当严重 缩水 感觉 以后 再 光顾 呵呵 	__label__0
粥 馊 点 鲜肉 包送 酱肉 包 搞 	__label__1
分量 味道 好 不错 值得 推荐 	__label__0
鸡肉饭 好吃 店 里面 饭 好吃 不贵 照片 之前 打包 鳗鱼 饭 山贼 牛肉 饭 赞 推荐 尝 一下 真的 nice 	__label__0
位置 学林 街 路口 向上 几家 清楚 看到 招牌 绝味 干锅 	__label__0
无语 吃 一半 蟑螂 腿 	__label__1
味道 环境 比较 好 感觉 沙坪坝 家 好些 	__label__0
味道 不错 老板 好 很帅 绅士 帮 加菜 菜品 新鲜 鸭肠 很脆 嫩 牛肉 香菜 丸子 很棒 好吃 环境 不错 推荐 	__label__0
观音桥 不夜城 下面 	__label__0
确实 特别 出乎意料 	__label__0
好 两盆 鱼 端上来 觉得 隔壁 	__label__0
味道 真的 不错 老公 喜欢 	__label__0
好吃 味道 一般般 	__label__0
蜜汁 烤 全鸡 难吃 两字 只 说 一次 	__label__0
环境 挺 好 服务态度 好 味道 小吃 下次 还会 光顾 	__label__0
超级 喜欢 面 清淡 嚼 劲 店里 干净 整洁 服务态度 超级 好 	__label__0
好吃 麻辣 口味 蒜 香 口味 挺 好 	__label__0
环境 好 味道 好 好找 地方 牛排 味道 不错 几十块 钱值 	__label__0
不错 餐厅 菜品 新鲜 口味 份量 很足 好评 	__label__0
摆 吃 肚子 好 疼 老公 拉肚子 估计 油是 潲水 油 以后 不吃 外卖 太脏 	__label__1
不错 服务 好 味道 稍微 有点咸 吃 淡 	__label__0
味道 不错 分量 服务态度 好 	__label__0
味道 不错 很香 实惠 	__label__0
吃 拉肚子 太坑 	__label__1
菜品 很足 合口味 值得 推荐 	__label__0
环境 不错 包间 里面 商务 谈 事情 高端 大气 只不过 要收 服务 消费 15% 茶水 要钱 	__label__0
备注 不理   客人 要求 不看 	__label__0
不错     态度 好   一共 团 八张 	__label__0
吃 虫子 真的 怀疑 饭店 卫生 过关 建议 这家 吃 卫生 真的 差 	__label__1
好 味道 服务 好 干净 卫生 	__label__0
好喝 现做 用藓 柠檬 榨 汁 勾兑 好喝 买 好 喜欢 	__label__0
特别 好吃 已经 吃 好 几次 下次 还会 	__label__0
环境 不错 味道 挺不错   美团 点餐 价格 划算 	__label__0
味道 不错 已经 第一次 光顾 	__label__0
环境 不错       遇到 一个 新 服务员 服务       服务员       速度 有点 慢       理解 	__label__0
态度 好 味道 不错 特 好吃 	__label__0
好吃 好吃 好吃 划算 不错 	__label__0
根本 瓦罐 汤 店家 太会 骗人 骗人 骗 长久 	__label__0
味道 好   菜品 新鲜   团购 划算   份量 足   下次 还会 再 	__label__0
划算 直接 买单 便宜 10 块 	__label__0
第三次 味道 好 强烈推荐 位置 	__label__0
环境 味道 不错 	__label__0
慢 说     我点 鸡块 送 半天 送 外太空 	__label__0
老板 人 不错 份量 很足 味道 巴实 物有所值 	__label__0
味道 不错 分量 足 团购 性价比 高 	__label__0
无 语 配送 慢 找 不到 路 味道 	__label__0
菜品 佳 分量 足 服务 不错 味道 不错 推荐 吃 	__label__0
品种 新鲜 环境 味道 好 推荐 	__label__0
一如既往 好吃 大学 四年 每年 吃 几十次 味道 好 便宜 	__label__0
店里 价格 说实话 真的 贵 全 果汁 加水 贵 团购 价格 说 比较 划算 味道 原味 添加 调味剂 一点 好 放心 	__label__0
放盐 吃 毛线 	__label__0
喜欢 这家 酸奶 牛 味道 不错 常客 	__label__0
位置 好 口味 好 菜品 新鲜 喜欢 吃 吃 	__label__0
冒火 根本 不看 备注 三样 东西 15% 主食 85% 全是 莴笋 叶子 你家 卖菜 点干 拌 汤 关键 尼玛 难吃 店家 一再 找 借口 必要 直接 图 找 借口 	__label__0
真的 无语 两份 量 店 一份 	__label__0
一如既往 没萨说 星光 店 上菜 速度 比较慢 接受 	__label__0
西瓜 品质 太差 西瓜 2.5 kg 份 ## 红萝卜 500g 萝卜 里面 康     差评 	__label__0
朋友 生日 订 送 过去 迟到 一小 下 口味 不错 	__label__0
大赞 重庆 经典 美味 至极 食品 干净 卫生 油而 不腻 百吃 不厌 价格公道 光顾 知道 后悔 一定 星光 时代 店哈 万达 店 服务 不周到 环境 星光 时代广场 感觉 万达 广场 好 万达 看着 憋屈 星光 时代 吃 完 金逸 影城 MAX 一下 美好 生活 ﹏ 	__label__0
味道 好 水果 小吃 送 下次 再 	__label__0
米线 泡容 本来 高兴 个虫 早知 该点 饭 	__label__1
味道 不错 服务 超级 好 昨天 晚 店家 依然 准时 送到 好评 	__label__0
觉得 经济 实惠 价格 不贵 	__label__0
味道 不错 有点 贵 	__label__0
我要 鱿鱼干 锅 全是 洋葱 豆芽菜 花钱 不值 以后 再 吃 豆皮 正宗 好 难吃 	__label__0
好 饮品 口感 好 店里 员工 服务 热情 	__label__0
卫生条件 不好 虫子 	__label__1
挺 实惠 味道 不错 	__label__0
菜品 味道 好 老板 人 好 	__label__0
饭 硬 冷饭 难吃 茄子 酸 筷子 凉拌 豆 干 太 随意 好 难吃 	__label__0
强烈推荐 机会 回来 商场 里面 实惠 味道 不错 	__label__0
适合 朋友 小聚 环境 清雅 味道 还好 	__label__0
吃水 煮肉 肉 豆芽 还少 分量 醉 坑点 	__label__0
味道 不错 环境 团 两桌 菜品 分量 十足 	__label__0
不错     好吃   味道 好   分量 很足     服务 不错 	__label__0
这次 分量 之前 	__label__0
老板 人 特别 好 环境 很棒 风格 下次 再 	__label__0
直接 卖家 换 商品 	__label__0
美女 老板   服务 热情     蛋糕 味道 不错     太大 吃不完 	__label__0
味道 好 位置 好 	__label__0
价格公道 便宜 吃腻 沁园 	__label__0
送 朋友 做 很漂亮 喜欢 最 重要 味道 特别 好 奶油 细 	__label__0
口味 很棒 服务态度 不错 干净 	__label__0
味道 特别 好 喜欢 麻和辣   钵 钵 鸡   热   好吃 	__label__0
位置 好找 家门口 滋味 街 环境 干净 典雅 菜品 新鲜 服务 热情 红油 锅底 免费 火锅 底料 特制 logo 吃 上火 菜量 丰盛 每盘量 足 餐位 费 元 包括 油碟 水果 新鲜 好吃 代金券 分 日期 时间 随时 使用 小吃 酒水 包括 在内 	__label__0
预定   早 送来 	__label__0
味道 好 物 廉价 美 吃 吃 想 吃 新鲜 	__label__0
味道 不错 地方 找 平时 人 	__label__0
饭 里面 米虫 有虫 虫 选 干净 眼不见 心不烦 确实 羊肉汤 已经 别家 吃 	__label__1
装修 好 看起 档次 我点 一个 药膳 鹅掌 味道 好 美味 下次 老板 热情 送 饮料 水果 实惠 	__label__0
环境 不错 位置 比较 好找 味道 挺不错 朋友 吃 挺 开心 	__label__0
只能 菜品 差评 办法 我点 藕片 雪花 肉 肥肠 味道 菜品 新鲜 鬼 吃 扔掉 只能 说 下次 	__label__1
几次 有点 餐 团购 服务态度 一如既往 好 	__label__0
牛排 好 姐姐 服务 好 那天 人 好久 好 	__label__0
回头客 一直 喜欢 好吃 赞赞赞 	__label__0
水果 过期 吃 拉肚子 	__label__1
性价比 高 值得 推荐 	__label__0
点个 外卖 筷子 真心 难受 	__label__0
云南 口感 放醋 秘制 酸菜 味 不错 	__label__0
服务 好           味道 不错       外省       吃 太 辣子       吃 确实 爽 	__label__0
老板 帅 口味 好 撑死 下午 老板 挺 忙 重 重庆 火锅 晚上 比较 火热 	__label__0
炸鸡翅 好吃 实惠 店 里面 10 块 只 需要 4.9 	__label__0
味道 完全 香 辣味 全是 酱油 味 蟹 新鲜 一股 腥味 吃 最 难吃 蟹 	__label__1
觉得 这份 里面 最 好吃 东西 饭 上面 榨菜 	__label__0
良心 商家 点赞 	__label__0
真 难吃 真肥 恶心 死 	__label__0
环境 够吃 菜品 新鲜 上菜 速度 味道 不错 	__label__0
好吃 披萨 价格 合适 味道 好 孩子 喜欢 青椒 挑出来 挑食 办法 	__label__0
整体 不错 比较 新鲜 	__label__0
不错 不错 一如既往 下次 朋友 吃 性价比 	__label__0
好吃 每次 跑 远 地方 吃 羊肉 粉 醉 喜欢 	__label__0
菜品 新鲜 服务 不错 价格 实惠 环境 好 值得 推荐 	__label__0
十三只 点 龙虾 小 没肉 没刷 干净 虾线 挑 里面 黑 异味 虾头 剪 从没 吃 差 龙虾 价格 太 不值 绝不会 点 第二次 	__label__1
一如既往 好吃 希望 再脆 一些 	__label__0
态度 好 喜欢 吃 	__label__0
分量 明显 不足 粉 煮化 	__label__0
鱼 真的 好吃 整体 不错 亲 试试 	__label__0
味道 不错 服务员 老板 好 菜品 有点 少 尤其 荤菜 菜 新鲜 	__label__0
点 猪扒 饭 味道 不错 价格 贵 性价比 高 环境 服务态度 人 满意 服务员 姐姐 太 热情 不好意思 	__label__0
味道 挺 好 老板 服务 错 下次 还会 	__label__0
味道 时间 太 长 	__label__0
第一 映像 装修 特别 吸引 很大 气 端上来 真的 惊艳 好大 一锅 色相 味 俱全 性价比 特别 高 一定 吃 排骨 感觉 一个 人 吃 一份 太 安逸 	__label__0
没吃过 难吃 饺子   肉 晓得 过期 肉   饺子 知道 包了 好久   一股 馊味   建议 谨慎 点餐   速冻 饺子 干净 卫生 	__label__1
点 温柔 锅 没敢 尝试 火爆 辣 重庆 本地人 觉得 温柔 锅 够味 锅底 不错 现炸 酥 肉 好吃 两个 人 吃 204 感觉 吃 很饱 晚上 六点 过到 停车 停 好 远 建议 停 枇杷 园 上面 走路 下来 	__label__0
好吃 环境 不错 吃 几次 	__label__0
喜欢 吃 龙湖 鸭肠王 很多年   一直 回头客   希望 方面 一直 保持 好 品质 赞 一下 	__label__0
饭 馊 饭 馊 饭 馊 饭 馊 饭 馊 不敢 吃 同事 闻 一下 差点 吐出来 	__label__1
味道 分量 足 	__label__0
丝袜 奶茶 好喝 鸡蛋 仔 好吃 	__label__0
莓 美 回忆 图片 好看 还行 味道 一如既往 	__label__0
一点 不好 纸巾 自备 买 不错 座位 有点 少 	__label__0
清淡 干净 环境 好 江湖 菜 烤串 不错 海鲜 煲 好吃 现场 音乐 听 服务 好 	__label__0
这是 回锅肉 套饭 逗我 	__label__0
知道 说 	__label__0
味道不好 吃 盐味 辣味 没得 味道 配送 慢 	__label__0
好吃 划算   便宜   分量 足 	__label__0
感觉 特别 好 新开 店 周末 老公 俩 人 里边 氛围 不错 喝 喝茶 聊聊天 	__label__0
好喝 好喝 茶味 比较 浓 喜欢 喜欢 	__label__0
味道 好 份量 很足 很麻 辣 吃 好 	__label__0
分量 味道 好 态度 比盛天 好吃 祝 美女 老板 生意兴隆 	__label__0
菜品 不错 环境 好 下 南川 高速 容易 找 	__label__0
气愤 打开 筷子 应该 忘 放 里面 整顿饭 知道 吃 郁闷 	__label__0
天     鸡肉 卷 里面 一只 蟑螂     太 恶心 	__label__1
菜品 不错 味道 好 	__label__0
牛排 好   烤雪鱼 好吃   	__label__0
分量 觉得 少 点 大人 小孩子 不够 吃 味道 	__label__0
味道 好 外地人 吃 真的 好辣 好 麻 地方 不好 找 酒香 巷子深 	__label__0
吃 一个 蟑螂 腿 意思     完全 食欲 	__label__1
味道不好 肉 好 难吃 	__label__0
送晚 两个 小时 不要紧 主要 难吃 	__label__0
每次 到熙 街 吃 吃 东西 价格 实惠 最 主要 好吃 强烈推荐 樱花 肉松 寿司 	__label__0
李子 耙 老年人 吃 全 扔 浪费 钱 	__label__0
好 蛋糕 好吃 水果 价格 比较 合理 	__label__0
一如既往 好 不错 吃 	__label__0
环境 不错 味道 不错 中午 吃 	__label__0
小朋友 喜欢 一大早 打包 回来 早餐 一如既往 水果 味 	__label__0
差评 秃 差 妈太远 	__label__0
点 168 人餐 菜品 味道 不错 关键 老板娘 漂亮 	__label__0
想 问问 吃 下去 奥尔良 鸡腿 ## 鱿鱼 须 	__label__0
原来 总是 侥幸心理 点 四次 该来 吃 两个 虫 小 蟑螂 恶心 爱 迟到 半小时 	__label__1
这家 店 主营 外卖 小店 进门 简单 桌子 凳子 厨房 食材 开放式 顾客 看着 放心 觉得 人 久 感觉不好 想 三星 吃 之后 发现 五星 好评 牛肉丸 放 五个 嫩 肉片 放 感觉 吃不下 千层 肚 特别 好吃 新鲜 爽口 素菜 分量 时蔬 莴笋 土豆 耙 口味 不错 端上来 米 饭碗 火锅 打包 盒装 餐具 外卖 那种 餐具 送 湿巾 店里 小哥 服务态度 好 很大 	__label__0
回来 吃 只不过 吃 不吃 汤锅 要加 10 块 喜欢 	__label__0
不错 人多 有点 嘈杂 菜品 丰富 地方 好找 经济 实惠 	__label__0
第二次 吃 味道 一如既往 地好 喜欢 泰式 宫廷 米线 	__label__0
刺身 新鲜 寿司 口感 好 环境 不错 山南 料理 值得 分享 	__label__0
吃 无数次 味道 好 好 回头客 	__label__0
吃 外卖 肚子 胃 疼 第四天 不想 说 一直 吃药 医生 说 急性 胃肠炎 吃 干净 东西 正好 那天 吃 朋友 吃 生病 没事 吃 吃 	__label__1
口味 相当 不错 服务态度 还好 值得 再 	__label__0
榴莲 披萨 好吃 实惠 价格 涨 点 	__label__0
服务 不错 价格 实惠 	__label__0
豆腐 碎 包装 油 	__label__0
服务态度 好 菜品 适合 朋友 聚餐 新开 酒店 环境 好 	__label__0
物美价廉 适合 朋友 聚餐 酒水 免费 	__label__0
菜品 丰富 吃 很饱 味道 不错 送 梅子 酒 好喝 	__label__0
小龙虾 确实 好吃 	__label__0
不错 主要 离家近 口味 好 	__label__0
我能 说 脏话 小时 送来 全冷 全冷   差评 写不出 心中 怒火 点定 11 点 送到     上床睡觉 	__label__0
不错 阿姨 好 讲 吃 东西 挺 	__label__0
味道 好 喜欢 吃 贵州菜 重庆 吃 满意 菜 下次 还会来 	__label__0
价格 特别 实惠 菜品 挺 吃 鸳鸯锅 加 十五块 	__label__0
吃 一如既往 保持 服务态度 不错 味道 	__label__0
量 吃 完 	__label__0
味道 好 	__label__0
超级 难吃 吃 两口 吃不下 鸡排 一点 鸡 排味 果汁 洗脚水 难 喝 死 	__label__0
环境 超棒 最 舒服 服务 服务员 一位 阿姨 热情 强烈推荐 口味 特别 好 	__label__0
一直 他家 一如既往 好 喜欢 吃 板栗 适合 养生 环境 好 上菜 服务 好 菜品 新鲜 感谢 店里 太好了 哒 	__label__0
很棒 男朋友 喜欢 	__label__0
说 货比三家 四五家 你家 最差 差 菜 味 吃 拉 几天 肚子 希望 买 外卖 买 这家 店 东西 少 味 吃 拉肚子 买 后悔 	__label__1
有个 馊味 儿   直接 丢 	__label__1
喜欢 奶盖 茶 服务态度 好 店里 环境 很棒 适合 逛街 累 坐坐 	__label__0
好 好 	__label__0
块钱 小米粥 骗人 	__label__0
老板 粉全 断 一点 粉 味道 做生意 	__label__0
味道 好吃 	__label__0
已经 来过 几次 味道 真的 不错 环境 人 温馨 感觉 下次 还会 继续 再来 	__label__0
强烈推荐 这家 味道 好 服务 好 活动 力度 以后 吃 焖 锅 这家 点 接待 吃 鱼 新鲜 点 两份 鱼 一个 鸭掌 一个 鸡 脆骨 鸡 脆骨 好吃 下次 点 	__label__0
小面 地道 串串 便宜 味道 不错 免费 豆浆 喝 	__label__0
味道 好 服务态度 不错 推荐 	__label__0
好多 坏 难吃 感觉 分量 不足 	__label__0
味道 挺 好 	__label__0
团 几次 好吃 	__label__0
人生 第一次 差评 店家 真的 太无语 迟到 久 忙 理由 说 太远 太远 设置 范围 不弄 这块 区域 OK 太忙 麻烦 忙不过来 接单 OK 喝粥 胃 舒服 雪上加霜 态度 不好 但凡 这种 情况 态度 好 点儿 真是太 失望 	__label__0
一如既往 好吃 好吃 好吃 好吃 	__label__0
最 SB 商家 备注 里 说 每次 送来 不冰 送 常温 味道 感觉 发臭 味道 杯 喝 全 扔 以后 买 西城 店 食品安全 不可 小 窥 	__label__1
薯条 耙 冷 热天 热 奶茶 	__label__0
味道 不错 服务 行 还会 再 	__label__0
味道 确实 好 重庆 第一家 最 好吃 	__label__0
四个 人 吃 完 雪糕 免费 吃 人气 很旺 不错 	__label__0
好喝 果汁 每次 必点 木瓜 雪 梨汁 大杯 划算 	__label__0
真的 好吃   老板 热情   一直 帮 烤 	__label__0
一家人 吃 味道 正宗 好吃 下次 回家 	__label__0
微辣 味道 不错 菜品 新鲜 甜品 好吃 大爱 	__label__0
回头客 一如既往 好喝 介绍 朋友 	__label__0
下次 下次 	__label__0
火锅 有点 辣 吃 第二天 拉肚子   味道 好   那天 记得 藤藤菜   有点 遗憾 	__label__0
味道 不错 团购 便宜 人太多 排队 太久 	__label__0
一如既往 爱 珍珠奶茶       真心 觉得 哪家 珍珠 贡茶         力推 每次 只 喝 今天 男票 点 抹 茶香 米 奶盖     速度 挺快   较场口 下车 找 得到     服务员 小哥 挺帅 hhhhhhhhh 招牌 珍珠奶茶 	__label__0
一如既往 好 物美价廉 还会 再 	__label__0
好 几次 卫生 服务 味道 杠杠 泡椒 蒜 香 好吃   大赞大赞 	__label__0
个人感觉 刨 酸奶 好吃 一些 方便 	__label__0
知道 是不是 关门 时接 味道 太 难吃 人 差评 只 吃 一点 浪费 几十 	__label__0
份量 服务态度 好 两个 人 份量 吃 完 	__label__0
味道 真的 好     本来 喜欢 吃 鱼 好 再 	__label__0
一份 蜂蜜 芥末 味 炸鸡 味道 不错 酱 稍微 少放点 更好 鸡肉 炸得 嫩 喜欢 	__label__0
味道 不错 性价比 高 实惠 	__label__0
速度慢 满意 请 做到 50 分钟 	__label__0
味道 不错 菜品 品相 不错 下次 还来 	__label__0
哒 一个多 小时 哒 真的 哒 送 慢   送得慢   送得慢   送得慢   送得慢   送得慢 	__label__0
味道 不错   份量 价格 还好 	__label__0
西瓜 好吃 炒饭 好吃 油碟 炒 鸡 棒 好像 再 回 重庆 吃 一次 	__label__0
老板 态度 不好 服务 很差 送餐 送 一个多 小时 打电话 过去 问 说 属于 正常 时间 辣味 辣味 难吃 	__label__0
新鲜 口感 不错 大人 小孩 喜欢 	__label__0
好吃 油死 入味 	__label__0
好吃 已经 第一次 消费 服务员 服务 好 团购 怠慢 	__label__0
一如既往 好吃 期待 新 菜品 最 喜欢 子 姜 牛肉 	__label__0
精瘦 肉 300g 份 精瘦 肉 真心 不想 吐槽 全是 肉 筋 平时 炒 两份 吃 精瘦 肉 肉 筋 踢 之后 只能 炒 一份 	__label__0
昨天 点 本来 不想 评论 昨天 吃 鸡腿 一股 子 怪味 没想到 今天 一天 肚子 痛 医生 医生 说 吃 变质 食物 干净 食物 导致 食物中毒 希望 评论 后 悠着点 点 	__label__1
已 顾客 推荐 朋友 这次 用餐 体验 却 糟糕 收到 袋子 全是 油 筷子 一份 鱼香肉丝 葱 占 三分之一 最 糟糕 吃 完 米饭 里 发现 一根 头发 心情 希望 商家 注意 点 卫生 所定 价格 对得起 产品 好 	__label__1
位置 好找 去过 沃尔玛 超市 右边 左拐 里面 位置 很大 环境 干净 味道 不错 	__label__0
一个多 小时   醉   久   菜 好吃     	__label__0
味道 相当 不错 不好 	__label__0
吃 几次 味道 不辣 适合 小孩子 吃 	__label__0
味道   分量 足   团购 态度 不好   值得 	__label__0
难吃 死 饭 冷饭 手 撕肉里 虫 凉面 硬 	__label__1
筷子 勺子 我用 手 抓 汤圆 汤圆 没得 一个 	__label__0
点 一份 滑 肉汤 端 上桌 却 看到 汤里 肉 餐馆 服务态度 不好 垃圾 差评 小菜 滑 肉汤 	__label__0
服务 好 紫米 感觉 太多 	__label__0
感觉 还好 反正 服务态度 不错 滴 点点 偏贵 只不过 沙坪坝 这种 地段 好像 团购 已经 便宜 	__label__0
环境 好 速度 干净 卫生 味道 好 	__label__0
服务 好 吃 好 老板 送 两个 菜 下次 还来 	__label__0
菜品 新鲜 味道 不错 推荐 品尝   小虾   黄辣丁 	__label__0
可乐 喝完 打开 盖子 一看 里面 有个 虫 真的 想 吐 	__label__1
全是 榴莲 系列 味道 很赞 	__label__0
难吃 分量 少 一共 两块 牛肉 贵 豆皮 一股 坏 味道 素菜 几样 坑 死 交 大学生 受骗 	__label__0
不错 优惠 味道 好 	__label__0
觉得 分量 好足 红薯 真心 好吃 	__label__0
吃 拉肚子 七个 人 	__label__1
第一次 团购 坐下 先 打个 全 五分 	__label__0
饭 有点 馊 	__label__1
味道 好 团购 便宜 店家 热情 以后 还会 	__label__0
n 次来 吃 宅子 干锅 味道 依旧 好 特别 喜欢 猪蹄 味道 很辣 却是 入味 团 张票 特别 划算 三种 喜欢 重庆 一年 干锅 吃 许多 家 感觉 寨子 味道 好 女朋友 本地人 说 家 味道 正中 好 	__label__0
服务 好 味道 好 	__label__0
吃 最 难吃 干锅 	__label__0
好吃 太辣 干锅 单人 套餐 	__label__0
棒 值得 推荐 服务 味道 不错 	__label__0
一如既往 好喝 good ฅ ω 	__label__0
环境 干净 味道 好 咸 喜欢 吃 菜 人 适合 吃 	__label__0
味道 好 值得 信赖 一家 披萨 店 	__label__0
打开 饭盒 闻到 鸡肉 新鲜 味道   反正 鸡肉 一口 吃   饭 吃 一口   贼 难吃   沙拉 吃 完   再点   包装 再 好 	__label__1
味道 好 以后 	__label__0
上菜 速度 有点 慢   菜品 好 	__label__0
好吃 男人 吃 拉肚子 还好 吃 	__label__1
味道 不错   有点 小贵 	__label__0
垃圾 里 战斗机 	__label__0
爸妈 说 环境 好 菜 好吃 	__label__0
昨天 打开 一股 腥味 果不其然 今天 两口儿 拉肚子 拉 一天 我操 	__label__1
价格 便宜 去过 好 几次 里面 真的 好多 梦露 o ≧ v ≦ o 	__label__0
顾客 离家近 宝宝 喜欢 味道 不错 	__label__0
巨 难吃   一股 怪味   肉片 一股 腥臭味   放 菜 相当 满意   吃 最 难吃 菜   难以 下咽   颗星 外卖 小哥   外卖 小哥 好 	__label__1
可乐 半杯 厉害 	__label__0
凯瑞 商都 新世纪 超市 楼上 现 炒 汤 有点 酸 性价比 高 	__label__0
最 喜欢 贡茶 熊猫 奶盖 团购 超 划算 	__label__0
味道 分量 太少 	__label__0
真心 不错 够味 吃 之前 拍 不够 辣 重庆 人 喜欢 下次 闺蜜 再 	__label__0
干干的 好 难吃 	__label__0
味道 真的 好 吃 好 	__label__0
汤 好喝 态度 好 	__label__0
分量 少得 可怜   味道 越来越 难吃 	__label__0
好吃 留香 排骨   速度 好找 服务 太多 挺 好 	__label__0
太 恶心 南瓜 里面 几十条 虫 害得 吃饭 心情 现在 想象 恶心 真 心想 吐 以后 再也 不敢 吃 南瓜 心理 阴影 特别 碗底 一排 一排 全是 虫 今天 一天 不想 吃饭 打电话 商家 说 只 退 南瓜 钱 本来 已经 心里 舒服 恶心 极点 后面 钱 全部 退 态度 食品 卫生   心里 阴影 恶心 再也 不敢 吃 这家 	__label__1
不想 爆粗 口 现在 只 想 吃 口饭 难 半天 下面 接近 一个 小时 打电话 电话 不接 这种 服务 接 说 装错 送错 地方 好 说 寝室 门 十几分钟 关门 理解 最后 句 行送 直接 退款 觉得 差钱 囊个 妈定 外卖 吃个 饭 好 算是 顾客 再也不会 垃圾 	__label__0
确实 霸道 物美价廉 值得 推荐 	__label__0
不错 味道 希望 老板 推出 团购 第一次 好找 万象 城 美食街 问 人才 找到 几次 好找 鸭血 粉色 超级 好喝 大碗 全部 喝 光光 服务态度 好 团购 看待 喜欢 	__label__0
好吃 一直 喜欢 第二次 第一次 好 下次 多喊 几个 朋友 一起 	__label__0
味道 不错 奶油 好吃 关键 每天 现做 新鲜 	__label__0
一如既往 好 味道 挺 好 团购 便宜 	__label__0
送餐 时间 迟 半个 小时 饿死 	__label__0
一如既往 好吃 这次 最 简单 一餐 	__label__0
分量 很足 味道 不错 	__label__0
味道 好 干净 特别 推荐 	__label__0
上菜 味道 还好 	__label__0
味道 好 份量 足 环境 干净 服务 	__label__0
太 划算 辣得 过瘾 	__label__0
感觉 不错 一如既往 支持 	__label__0
环境 好 价格 实惠 味道 	__label__0
服务员 态度 好 味道 不错 环境 值得 推荐 下次 一定 再 	__label__0
感觉 三个 人 完全 够吃 味道 好 老板娘 热情 生意 太好 服务员 有点 忙不过来 人 说 团购 热情 有时候 人 互相理解 觉得 团购 另眼相看 生意 好 顾不过来 正常 	__label__0
味道 不错 价格 实惠 赞 一个 	__label__0
真的 好吃 好久 没吃过 好吃 烤鱼 之后 老板 团购 歧视 问 老板 够不够 两个 人 吃 不够 好 先 加菜 老板 说 吃 完 够 耿直 味道 真的 超级 棒 	__label__0
味道 不错 吃 泡椒 火腿 很辣 稍微 点点 咸 值得 推荐 店里 狗狗 听话 以后 再 	__label__0
环境 好 服务 不错 口味 有点 喝 习惯 	__label__0
吃 拉肚子 应该 粥 问题 	__label__1
服务 好 东西 好吃 划算 	__label__0
米饭 我晕 	__label__0
不错 两个 人 吃 吃 完 分量 	__label__0
味道 好 不用 排队 体验 一下 	__label__0
味道 好       尤其 爱上 锅贴 饺       朋友 说 好吃     分量 挺 足         是不是 团购     态度 好     爱 搭 不理 	__label__0
好吃 	__label__0
喜欢       店内 装修 很棒     菜品 味道 不错     喜欢 一个 甜品 发糕       免费 添加 	__label__0
好     最 爱 酸奶 牛   	__label__0
菜品 服务 不错   下次 机会 再 	__label__0
划算       不错       下次 再 买   分量 足     	__label__0
菜少 送 瞎 送 强行 换 菜品 提前 打招呼 难吃 有下 一次 	__label__0
菜品 丰富 服务周到 味道 不错 	__label__0
味道 不错 大胃 王 来说 分量 有点 少 嘿嘿 	__label__0
6666666 不错 豆浆 好 服务 不错 	__label__0
分量 足 下次 武隆 机会 继续 关照 	__label__0
味道 环境 真心 不错 服务 热情 朋友 聚餐 好 地方 	__label__0
东西 不齐 认真 订单 	__label__0
一家 位置 好找 地铁 二号 出口 小吃街 位置 比较 窄 生意 挺 好 团购 价钱 力 味道 比较 正 这次 感觉 煮 好像 有点 轻 下次 希望 煮 熟 一点 比较 喜欢 毛血旺 分量 十足 	__label__0
筷子 一双   醉   太差 咯 	__label__0
重点 便宜 团购 划算 	__label__0
一直 这家 吃 味道 好 服务 好 	__label__0
吃 最 难吃 烧烤 实物 为证 这中 翅 支离破碎 藕 感觉 酸 蒜泥 茄子 蒜泥 生 东西 晚点 二十分钟 说实话 一百块 钱 吃 全 扔 关键 今天 拉肚子 老板 下次 用些 心 	__label__1
味道 不错 好好 好好 好好 好好 好好 好 	__label__0
全是 油 地沟油 钱 说 	__label__1
面上 蚊虫 醉 	__label__1
鹅掌 好吃   米线 好吃   位置 好找   吃 	__label__0
挺 好   干净 卫生   有点 偏   差点 找到 	__label__0
少要 30 大洋 我家 楼下 10 元 拼盘 	__label__0
提前 店员 说好 点 准时 吃饭 喊 菜 准备 好 准时 菜 楼上 十个 人 菜 份量 很足 好吃 超值 以后 机会 一定 还来 	__label__0
位置 好找 味道 很错 美女 态度 好 值得 购买 	__label__0
顾客 	__label__0
一如既往 好吃 服务 周到 	__label__0
好吃 欲罢不能 好 好 	__label__0
强烈推荐 榴莲 奶昔   超级 好喝   要加 冰块   味道 比较 浓郁 	__label__0
帮别人 点 根本 收到 东西 知道 打电话 关机 黑店 迈 	__label__0
难吃   难吃   难吃   说 辣椒 包 一包 呵呵 好 难吃 	__label__0
公司 楼下 吃 番茄 味 好吃 	__label__0
吃 完 发现 一只 苍蝇 整个 人 不好 	__label__1
龙虾 饭 吃 一个 小时 拉肚子 气愤 	__label__1
包被 扔 地上 吃 	__label__0
太 难吃 全部 扔 泡椒 鱿鱼 煲仔饭 ## 尖椒 鸡 煲仔饭 ## 茄香 煲仔饭 	__label__0
点 芒果 芋圆 一如既往 好吃 喜欢 	__label__0
不错 量 合适 刚刚 好 浪费 环境 特色 安静 菜品 味道 不错 丰富 	__label__0
买 这家 海盐 脆脆 以前 咸咸的 味道 今天 送来 以前 一点 不像 有点 巧克力 感觉 客服 电话 骑手 电话 说 一个 人 说 味道不好 不算数 拿回去 尝尝 骑手 电话 骑手 说 不关 事 负责 送货 说 货 过期 说 过期 味道 问题 找 买 认栽 	__label__0
味道 好 超级 便宜 良心 商家 	__label__0
团购 划算 团购 爱 吃 菜 浪费 商家 能换 同价位 菜品 好 	__label__0
第二次 家买 值得 推荐 	__label__0
吃 几次 不错 	__label__0
份量 十足 味道 好吃 真心 划算 	__label__0
牛肉 不错 吃 	__label__0
特別 貼心 店家 很感 謝贈 送 漂亮 蠟燭 蛋糕 貼別 好吃 強烈 推薦 	__label__0
味道 好 实惠 值得 吃 便宜 	__label__0
味道 吃 几次 觉得 需要 改进 牛排 海鲜 需要 多下点 功夫 	__label__0
上菜 速度 比较 味道 不错 服务态度 不错 	__label__0
骗人 排骨 全是 尾椎骨 很大 一坨 坨 根本 食欲 	__label__0
我点 宵夜 变成 早餐 5.30 送来 	__label__0
每次 点 特辣 味道 霸道 	__label__0
公司 楼下   天天 吃 鸡块 好吃   汁水   早餐 太 划算 	__label__0
饭团 一股 馊味 醉 	__label__1
吃 一半 突然 发现 里面 只 小强 	__label__1
小龙虾 新鲜 圣子 太咸 无话可说 坐等 明天 拉肚子 	__label__1
同事 吃 完 拉肚子 下午 肚子 舒服 	__label__1
虾 异味 骨肉相连 完全 差点 吃 吐 天气 热 注重质量 	__label__1
服务 好 口感 好 位置 好找 	__label__0
差评 第一次 喊个 外卖 第一次 差评 一锅 鸡 里面 吃 二次 长 头发 再也 不想 叫外卖 品质 人 堪忧 	__label__1
好 地方 好找 环境 不错 上菜 分量 不错 	__label__0
今天 太辣 吃 拉肚子 	__label__0
这次 好 难吃 法式 香蒜条 袋 ## 法式 传统 羊角 包 	__label__0
不错 味道 鲜美 番茄 熬 汤 粉红色 食欲 满意 	__label__0
农家 小 炒饭 肉 	__label__1
环境 不错 牛肉 很软 分量 后足 面筋 道 服务员 态度 好 	__label__0
一如既往 好吃 服务态度 好 强烈推荐 	__label__0
味道 好   一如既往 喜欢 喝 	__label__0
夹生饭 腊味 土豆 箜饭 饮料 开胃菜 时蔬 	__label__1
太 恶心 吃 完 吃 虫 	__label__1
味道 好 小吃 不错 吃 开心 	__label__0
菜 新鲜   微辣   鹌鹑蛋 新鲜   特别 里面 有块 血旺 唯独 一块 知道 是不是 剩 直接 丢   不想 吃   太 坑人 	__label__1
大杯 实惠 味道 不错 	__label__0
评价 说 好吃 买 三个 吃 好吃 口味 蛋糕 很漂亮 	__label__0
一家 小店 味道 赞 樱花 卷 好吃 不错 	__label__0
好吃 好吃 好吃 好吃 还会 再 吃 坨 坨 肉 鲫鱼 好吃 	__label__0
味道 不错 环境 挺 好 井水 豆芽 好 脆生生 位置 找 	__label__0
楼下   吃   老板 人 不错 	__label__0
左右两 部分 完全 一个 辣 味道 一半 咸 无法 下 口 只 吃 几口 点 这次 	__label__0
环境 好 新 天泽 万达 旁边 坐在 朋友 舒服 味道 好 店 小 干净 坐一 下午 好 坐坐 人 电影 买 一杯 好 价格 便宜 很大 杯 人多 排队 	__label__0
明明 点 香肠 香肠 一块 看不到 越做越 假 	__label__0
吃 完 一份 赶紧 下单 再 一份 节奏 	__label__0
慢 好吃   人 饿求 疯 	__label__0
觉得 难吃       一点 味道 做       汉堡 里面 放 菜叶 烂 菜叶       良心 痛     差评       这次 真的 满意         鸡翅 馊       奉劝 换家店 	__label__1
一如既往 好吃 价格 公道 	__label__0
鸡丁 馊 味 难以 下 口 	__label__1
知道 老板 想 nbsp nbsp 饭 馊 nbsp nbsp 送过来 很大 一股 味 nbsp nbsp 最后 根本 沒 心情 吃 nbsp nbsp nbsp nbsp 真的 很气 nbsp nbsp 	__label__1
好 好 口感 好 夹心 好吃 	__label__0
太油 饭 有点 馊 凉皮 不错 	__label__1
人 说明 味道 好 昨天 生日 家人 吃 两个 大人 一个 小孩 分量 觉得 稍稍 偏咸 点点 口味 尝尝 环境 好 凉拌 黄瓜 新鲜 爽口 好吃 	__label__0
味道 不错 分量 够 呵呵 呵呵 	__label__0
常去 地方 可惜 现在 中国银行 信用卡 使用 要求 高 少 优惠 	__label__0
只能 说 只能 骗 一次 梨子 知道 梨子     只能 告诉   吃 异味     梨子 泡沫     水份   放 久 拼盘 说     渣       卖 水果 卖成     成功 所有 水果 只 吃 一下     全 扔 	__label__0
味道 好极了 	__label__0
团购 菜品 份量 少 一些 味道 	__label__0
口味 一如既往 好 人气 火爆 需要 排队 好好 好 	__label__0
老板 服务 到位 当天 订 老板 说 需要 款式 做 不错 一家 蛋糕店 	__label__0
分开 很足 味道 好 太多 后面 吃 闷 	__label__0
服务员 态度 好 菜品 新鲜 味道 不错 	__label__0
味道 好 喜欢 	__label__0
味道 不错   分量 很足   上菜 	__label__0
配送 时间 太 不准 八点 十七 下单 十点 收到 不说 味道 一点 不好 油 没得点 浪费 80 块钱 再也 你家 	__label__0
  美味 店主人 好   甜 辣酱 完美 	__label__0
这家 冒菜 确实 难吃   盐巴 打倒   咸 安逸 算了   关键 菜 晓得 放 好多天 淡淡 酸 臭味   真的   无骨 凤爪   全是 骨头     确实 遭 上当                         PS 劝 上班 朋友 些   喜欢 点 外面 朋友 些 要点 这家 兄弟 伙 真心 评价 店主 不用 打电话 骚扰     消费者 权益 送 快餐 小哥 人 不错   乱点 差评 	__label__0
每次 万达   味道 不错 	__label__0
吃 最 难吃 一家 冒菜 菜品 不好 	__label__0
已经 去过 一如既往 喜欢 	__label__0
东西 好吃 上周末 吃 唯一 水果 新鲜 	__label__0
真的 醉 炒菜 卖得 炒 难吃 最 垃圾 一次 外卖 烧个 汤 里面 一个 虫 看到 恶心 	__label__1
速度慢 加饭 还要 加 元 	__label__0
第二次 吃 扫码 叔叔 态度 好 问 吃 旁边 票 忘记 有人 说 票 说 很快 弄 好 不错 今天 吃 太 吃不下 冷 好吃 吃 位置 找 不错 	__label__0
鱼 嫩 好吃 可惜 点 有点 少 不够 吃 下次 重庆 一定 还要 吃 	__label__0
冷掉 勺子 真的 服 	__label__0
吃 四五次 确实 今天 朋友 一起 喜欢 吃 培根 	__label__0
太咸     两样 菜 咸 鸡肉 分量 一点点 吃 最 难吃 吃 浪费 钱 不点 这家 菜 吃 	__label__0
人 套餐 完全 吃不完 菜 味道 不错 值得 推荐 	__label__0
环境 不错 露天 服务 好 味道 不错 	__label__0
不错 服务 周到 小朋友 喜欢 工作人员 送 机器猫 微信 上发 朋友 说 喜欢 说 有空 谢谢 	__label__0
吃 好 味道 真的 好 	__label__0
一直 喜欢 这家 火锅 味道 不错 耗儿 鱼 黄喉 超级 好吃 	__label__0
味道 口味 较场口 那家 肉 很嫩 	__label__0
味道 不错 价格 不贵 	__label__0
已经 偏向 中国 消费者 口味 味道 比较 赞 亲们 品尝 一番 	__label__0
奶盖 细腻 味道 纯厚 好喝 绿茶 味 清香 很大 一杯 实惠 	__label__0
特别 好吃 环境 不错 老板 人 好 	__label__0
矿泉水 忘记 	__label__0
不错 土豆 好吃 吃 	__label__0
味道 不错 服务态度 挺 好 比较 值 	__label__0
重庆 网红 赞 	__label__0
份量 足 味道 好 位置 不大好 找 	__label__0
味道 好   价格 实惠   过来                             	__label__0
不错 两个 人 吃不完 两 三包 回去 吃 	__label__0
菜品 味道 好 服务态度 好 	__label__0
好吃 好吃 好吃 死   划算 哭 	__label__0
蛋糕 超级 好吃 便宜 划得来 	__label__0
以前 订 虾 差得 太远 太远 总共 二十 来个 虾 烂 虾 死 虾 接近 一半 差虾 钳 甚者 几个 虾头 里面 绿 最 恐怖 变异 太难受 一次 小龙虾 经历 砸 渝 派 招牌 	__label__1
虾子 有点 怪味 估计 食材 新鲜 	__label__1
不错 服务 挺 好 环境 不错 值得 推荐 汤菜 半天 	__label__0
味道 好 环境 不错 同事 吃 超级 开心 开心 	__label__0
比较 丰盛 味道 不错 	__label__0
味道 巴适 老板娘 热情 分量 很足 小 吃 完 	__label__0
沾水 调料 不错 汤 比较 好喝 	__label__0
一如既往 好 味道 好 吃 剩 好多 	__label__0
感觉 上次 好吃 些 酱油 换 吃 腻 这次 辣椒 好辣 再 加点 醋 正宗 酸辣 口味 辣椒 好 食欲 双皮奶 好吃 正好 解辣 	__label__0
写字楼 里面     环境 好   菜 味道 	__label__0
预约 想着 下班 路过 南坪 区府 直接 顺利 换 态度 超好 	__label__0
两次 服务态度 好 菜 有点 辣 挺 好 	__label__0
蛋糕 新鲜 店家 服务态度 好 团购 划算 	__label__0
差评   奇异果 切片 蛋糕 打开 直接 馊 临期 食品 鬼 华生园 做生意 差评 差评 差评 	__label__1
苍蝇 一个 才学 节肢动物 人 来说     真的 人 不好 	__label__1
一点 好吃 生 	__label__1
味道 好 感谢 商家 活动 	__label__0
酥 肉 新鲜 异味 	__label__1
牛排 好吃 来过 几次 特别 喜欢 爬 爬 虾 入味 布丁 好吃 菜品 挺 选不 过来 忘记 拍照 习惯 吃海鲜 推荐 这家 	__label__0
菜 挺 	__label__0
味道 不错 宝贝 喜欢 环境 不错 老板 热情 	__label__0
好吃 骗人 	__label__0
第一次 吃 羊排 抓饭 米饭 很香 颗粒 晶莹 饱满 羊肉 胡萝卜 汁 汁 香味 渗透到 米粒 里面 调味料 羊肉 味道 真实 软烂 鲜香 喜欢 这种 尊重 食物 还原 食材 味道 用料 简单 做法 健康 营养 真心 推荐 	__label__0
龙虾 做法 卫生 头 去掉 真 没见 做过 掉头 第一次 买 最后 两张 家 做法 	__label__1
环境 不错 服务态度 好 味道 不错 	__label__0
从点 餐到 送达 一个 小时 二十分钟 快递 迟到 二十分钟 分量 太少 明明 点 大份 最小 盒子 装 啥子 配菜 只想 说 吃 两年 最坑 鸡公 煲 点 满意 	__label__0
好吃 好吃 先 说 预计 12 26 送达 晚 大半个 小时 点 外卖 图个 方便快捷 打电话 催单 两个 电话 过去 店里 生意 做 真大 不用 老板 人 	__label__0
味道 好   吃 一个 人 便宜 	__label__0
干 炒 牛河 里面 吃 一根 很长 刷 碗 钢丝 球 心情 崩溃 	__label__1
一如既往 好 团好 几次 强烈推荐 	__label__0
真心 好吃 想 问 店家 吃 过八爪 鱼 样子 头   还八爪 鱼   完全 鱿鱼 须 味道 难吃 虾子 难吃 要命 想 吃海鲜 点 家 本来 怀着 尝试 态度 试一试 结局 真是 令人 失望 	__label__0
忘点 一份 饭 再点 一份 标价 一元 配送 过来 让我拿 两元 意思 一份 饭 装 一半 分量 别提 味道 下次 	__label__0
家 老店 味道 越做越 好 牛肉 吃 一个 爽 味道 相当 相当 巴适 	__label__0
超棒 口味 独特 面条 好吃 服务 好 	__label__0
难吃 米饭 真的 无法 吃 	__label__0
味道 配送 不敢恭维 小时 送到 	__label__0
挺 好喝 服务 不错 下次 再来 光顾 	__label__0
猪蹄 好吃 	__label__0
不错 自助餐 菜品 新鲜 味道 不错 他家 牛排 好吃 	__label__0
两年 夜市 追随 店面 正宗 东北 烧烤 正宗 东北 味 巴适 	__label__0
菜品 味道 好 干净 服务 还会 光顾 	__label__0
黄桃心 心烂 淡而无味 	__label__0
第一次 服务 挺 好 分量 足 两个 人 吃 完 下次 换个 口味 儿 试试 	__label__0
菜品 质量 差   特别 饭 稀 好吃 太辣 	__label__0
第二次 团 以前 团购 吃 非常适合 老人 小孩 兔子 肉 嫩 认为 特别 好吃 忘记 照相 满意 一次 团购 	__label__0
完全 环境 菜品 服务 好 	__label__0
服务 很棒 菜品 特别 口味 不错 环境 好 人 大提琴 小提琴 演奏 韩国 料理 东西 比较 少 口味 太 习惯 	__label__0
牛排 口感 挺 好 菜品 略少 	__label__0
解释 一如既往 思思 思思 思 	__label__0
好 分量 足 两个 人 吃不完 	__label__0
鸡块 肉 鸡翅 一根 很长 鸡毛 服 再也 不点 	__label__1
太 失望   味道 不行   虾点 新鲜     差评 	__label__1
万达 金街 正 新鸡排 必胜客 后门 处 生意 好 美团 套餐 价格 十分 优惠 一块 大鸡排 一杯 酸梅汤 组合 价廉物美 鸡排 现炸 久 做好 味道 挺不错 外 酥 里 嫩 分量 足 店里 烤肉 品种 	__label__0
老婆 喜欢 味道 好 不错 	__label__0
客观 评价 手 抓 饼 加 东西 卖 块 觉得 贵     土豆粉 几根         真心 垃圾 	__label__0
快递 力 鸡杂 咸死 人 全部 倒掉 	__label__0
上菜 慢 生意 太好了 味道 行 	__label__0
第一次 网上 订 这种 私 作坊 蛋糕 心里 没底 吃 满意 没想到 价格便宜 蛋糕 好吃 送到 家门口 去取 满意   提拉 米苏 蛋糕 	__label__0
好吃 酸菜 味 特别 下饭 菜品 干净 	__label__0
好 难吃 感觉 菜品 烤 馊 	__label__1
口味 不错 正宗 	__label__0
上菜     味道 好     环境 挺 格调       服务周到     好评 	__label__0
不错 已经 第二次 好 	__label__0
一如既往 好吃 每周 吃 一次 	__label__0
味道 不错 物美价廉 感觉 不错 	__label__0
味道 不错 生 煎 包 门口 家 好吃 便宜 	__label__0
不错 特别 红烧肉 服务态度 超级 好 送 笔记本 抵用券 	__label__0
味道 一如既往 好 芒果 卷 喜欢 李 公主 多一点 芒果 卷 适合 甜点 	__label__0
味道 真的 好 一饿 会团 一家 	__label__0
虾     调料 知道 鬼   拿个 塑料袋 装 	__label__1
鸡杂 里面 吃 好多 头发 	__label__1
好吃 	__label__0
东西 好吃 鸡肉 很嫩 其他人 评价 说芋 儿 好吃 就加 一份 确实 不错 服务 好 中间 有个 小 插曲 帮 解决 朋友 面前 出丑 太 感谢 	__label__0
价格 实惠 好吃 店主人 好 蛋糕 很漂亮 加 水果 	__label__0
人 吃   再也 不喊 这家 	__label__0
不错 感觉 划算 嘿嘿 	__label__0
离家近 蛋糕 不错 h 	__label__0
在家 附近   味道 一如既往 地好   还会 再 	__label__0
赠送 脆骨 串 可乐 吸管 	__label__0
味道 不错 关键 速度 太快 	__label__0
服务 好 好吃 孜然 麻辣 好吃 	__label__0
味道 不错 店家 贴心 帮忙 讲解 应该 吃 好吃 服务态度 好 那天 生意 特别 好 老板 几桌 转来转去 辛苦 	__label__0
打开 盒子 一条 虫 本来 送 晚 这种 无语 	__label__1
两个 人团 四人餐 剩 四个 菜 吃 已经 吃 撑 味道 很赞 老板 好 送 一壶 银耳汤 吃 后头 咸 	__label__0
配送 及时     一直 好吃 ｢ ･ ω ･ ｢ 	__label__0
不好 说 豆花 吃 烧菜 只 吃 坨 真的 建议 老板 尝 一下 晓得 撒子 味道 好重 骚味 第一次 遇到 这种 味道 ...... 	__label__0
一分 点 老板 真是 坑 打包 点 差评 	__label__0
天绿来 好 几次 寿司 神马 超 好吃 	__label__0
先不说 好吃 包装 照片 实物 相差太大 口味 提高 	__label__0
菜品 好 味道 超捧哟 吃 虾 肥肠 混 配菜 好 藕 韭菜 年糕 不错 不错 	__label__0
送个 餐要 几把 一个 小时 草 几把 饿死 	__label__0
第一次 解放碑 店   服务 一如既往 地赞 	__label__0
味道 不错 当时 老公 吃 过后 几次 	__label__0
钢丝 球 卫生 差得 	__label__0
第一次 优惠 两人餐 份量 足 不错 	__label__0
已经 团购 过好 几次 味道 好 	__label__0
服务 不错 菜品 齐全 份量 少 点 	__label__0
菜品 味道 不错 服务 稍差 	__label__0
口感 好 菜量 足 鱼 新鲜 花生 好吃 	__label__0
鱿鱼 腥味 太重 五花肉 两小片 	__label__0
唯一 喝 各种各样 粥 餐厅 喜欢 喝粥 懒得 煮粥 人 真的 很棒 	__label__0
好 评价 吃 两次 烤鱼 锅 干净 增加 人 食欲 店里 环境 干净 卫生 服务 好 味道 好 鱼 有点 小 做生意 有点 利润 总体 来说 好 饮食店 做到 位 回去 光顾 	__label__0
味道 挺 好 龙虾 辣辣的 干锅 不错 配菜 点 鱿鱼干 锅 里面 全是 鱿鱼   老板 太 实诚 建议 配 点菜 里面 	__label__0
两个 人去 吃 我俩 饿 好吃 完 四个 人 分量 有点 少 	__label__0
螺丝   鱿鱼   整盒 味道 搞 变     做生意 诚信 重要   差评   确实 忍 不到 	__label__1
环境 优雅 品种繁多 菜品 一流 超赞 超值 	__label__0
菜品 十二个 人 完全 够吃 服务周到 下次 再 	__label__0
今天 吃 烤鸭   上瘾   不错   好评 	__label__0
半天 送来 菜 饭 最后 难吃 全是 肥肉 	__label__0
不错 不错 环境 食物 比较 好吃 	__label__0
脆皮 手枪 腿 	__label__1
不错 不错 回头客 菜品 丰富 服务态度 好 积极 帮助 解决问题 	__label__0
味道 太好 分量 足 周边 上班 朋友 推荐 超值 	__label__0
挺 好 味道 服务 不错 	__label__0
小时 送到 	__label__0
土豆 很大 一股 药味 吃 面条 送过来 已经 泥 	__label__0
酸 汤 味道 真的 本来 喜欢 吃 酸 这家 酸 汤鱼 真的 太 口味 鱼 嫩嫩的 味道 鲜美 喝汤 之前 喝 菜 放下去 汤 味道 素菜 免费 吃 噢 种类 老板 老乡 服务态度 热情 这次 忘 拍照 下次 吃 拍图 	__label__0
店里 环境 不错 干净 舒适 老板 人 热情 三个 人去 点 一个 单人 餐 一个 双人 餐 分量 足 砂锅 肥肠 砂锅 排骨 味道 不错 辣 跳 鸭肠 新意 吃 完 好涨 下次 	__label__0
挺 好喝 会常去 喝 味道 特别 不错 特别 棒 强烈推荐 	__label__0
不错 	__label__0
吃 几次 这次 有点 失败 点 汤 点错 	__label__0
难吃 死 里边 一根 不明 毛发 瞬间 呕吐 	__label__1
骑手 真是 老辣 鸡 	__label__0
好 第二次 吃 满意 	__label__0
好吃 已经 买 	__label__0
东西 少 打电话 说 退 	__label__0
搞了半天 送货 过来 	__label__0
蚂蚁 上树 馊 6666 	__label__1
味道 好 份量 足 	__label__0
好吃 好吃 好吃 位置 找 老板 人 热情 	__label__0
去过 几次 桂山 公园 门口 团购 挺 划算 分量 很足 五六个 人 够吃 	__label__0
第二次 吃   来得早 人不多   菜品 挺 	__label__0
超级 差评 没叫 垃圾 外卖 送餐 筷子 四十分钟 筷子 送来 饭 凉 人 饿死 	__label__0
鸡肉 好像 有点 好 难吃 再也 点 这家 包装 接受 夏天 买 肉 顾客 	__label__1
他家 顾客 上菜 服务 热情 唯独 不好 岁 小孩 算油 碟 	__label__0
好 不错 服务 菜品 好 还会 再 好评 	__label__0
菜品 味道   就餐 氛围 却 超级 棒   每次 新 惊喜 	__label__0
味道 好 份量 很足 	__label__0
刚刚 点 牛肉 明显 商家 部分 坏掉 牛肉 煮 里面 真的 太过分 	__label__1
重 没吃过 难吃 烧鱼 超 难吃 	__label__0
做 下午 作业 	__label__0
牛排 味道 不错   当时 团购 新人 第一次   二十 几块钱   超 划算 	__label__0
人 蔬菜 单独 一锅 排骨 虾 锅 好吃 排骨 虾 味道 好 	__label__0
炒面   送来 炒饭   好吃 	__label__0
味道 不错 服务 实惠 	__label__0
好 团购 好 不错 	__label__0
吃 好 自助 火锅 	__label__0
点 苏打水 送过来 	__label__0
服务 行 味道 不错 最近 迷上 	__label__0
卫生   吃 后面 只 苍蝇 苍蝇 苍蝇 恶心 死 	__label__1
味道 真棒 火锅 真正 宗 服务态度 好 配料 地道 	__label__0
肉嫩 紫 薯条 超 好吃 价位 合理 	__label__0
味道 不错 分量 足 送 银耳汤 解暑 好 自助 串串 蔬菜 肉类 新鲜 试试 	__label__0
分量 足 味道 不错 最近 人 	__label__0
味道 好 值得 一去 团购 价格便宜 希望 继续 团购 活动 	__label__0
处女 差评 呵呵 商量 良心 荤菜 一共 三片 午餐肉 分量 建议 广大 不爱 吃 肉 女生 多点 一下 哈哈哈 	__label__0
味道 好 菜量 很足 	__label__0
地理位置 好 地铁口 看到 很大 气 招牌 进门 有人 热情 招呼 服务员 态度 超级 好 一直 面带微笑 嫩 牛肉 裹 香菜 鹅肠 嘎嘣脆 锅底 辣度 适中 以为 很辣 服务员 建议 微辣 符合 口味 整体 感觉 好 以后 会常来 	__label__0
菜品 质量 差   拉肚子 晚上 	__label__1
      这是 韭菜           找到 地方 凶 	__label__0
去过 好 便宜 好次 	__label__0
买 招牌 藕   网上 点 买 男朋友 吃   男朋友 告诉 收到 东西 时 藕 坏   一股 馊 味道   坏东西 买   还要 良心   吃 拉肚子   你付 责任 差评 差评 差评 	__label__1
满意   好   服务 好 环境 好   好 好 	__label__0
饭太硬 吃 吃 塑料 不敢 吃 菜 太 咸 吃 完 	__label__0
好吃 店 旁边 坐 一发 不可收拾 一个 人 算 得分 机会 获得 免费 下载 一个劲儿 得意 得意门生 一起 吧嗒 饿 睡不着 觉 是从 变好 一起 有点 钱 夹 韩版 修身 男士 休闲裤 豆干   红烧 羊排   凉拌 羊肚   羊肉汤 	__label__0
环境 好 菜品 新鲜 下次 继续 光顾 	__label__0
吃 最差 外卖 nbsp nbsp 吃 完 一个 小时 拉肚子 nbsp 呵呵 哒 nbsp 搞 现在 虚脱 	__label__0
大融城 35 楼 双人 餐 48 味道 好 乌鸡汤 里面 一根 天麻 物超所值 养生 值得 推荐 地方 点点 隐蔽 中午 离开 俩 吃 觉得 好 地方 生意 应该 更好 才行 唯一 一丁点 不足 应该 乌鸡 天麻 汤 炖久些 	__label__0
太 小心 虫子 	__label__1
辣椒 味道 别家 好吃 座位 还点 份 洋芋 花   味道 不错 	__label__0
谢家 湾 点 一如既往 好 赞 喜欢 炸 酥 肉 	__label__0
速度 挺快   好好 好   	__label__0
牛排 不错 价格便宜 味道 杠杠 	__label__0
点 两份 饭 送 一份 想 顾客 点错 以为 送 一份 需要 两份 点 两份 只 送 一份 吃 说 下雨 方便 送 只退 一份 饭钱 明白 只 送 一份 饭 带来 损失 问 饭 补齐 整个 东西 全部 拿走 好     一点 动 申请 全额 退款 干         服务 问题 最后 消费者 我来 承担     极致 差评 接电话 同学 意见 同意 同意   极致 差评 	__label__0
总是 筷子 	__label__0
饭闻 馊     吃 	__label__1
不错 吃 味道 好 	__label__0
品种 挺 挺 好 	__label__0
足足 小时 20 分钟 有余 及时 送到 至少 第一次 催单 说明 一下 情况 撒 顾客 傻起 	__label__0
味道 好     份量 足     朋友 吃 开心     很撑 	__label__0
筷子       翅 中       不想 说 	__label__0
菜品 好 服务周到 人 特别 	__label__0
好 比较 喜欢 吃 肉 牛排 多点 好 总体 吃饱 西餐 注重 情调 闺蜜来 棒 环境 好 小资 情调 感觉 夜景 漂亮 总体 满分 	__label__0
点 菜 里面 点 酥 肉 酥 肉 鬼 	__label__0
还行 位置 相对 比较 偏 总体 	__label__0
蒜 香 猪蹄 ## 麻辣 猪蹄 本来 吃 一个 之后 觉得 味道 第二个 发现 只 死 苍蝇 想 吐 	__label__1
送货 速度 超级 慢 人 饿 不行 	__label__0
服务态度 挺 好   买 水果 蛋糕   水果 好酸 	__label__0
烤鸭 不错 味道 好 环境 挺不错 	__label__0
不想 说肉 干锅类 小份 	__label__1
本来 周围 找鱼 吃 看到 团购 正好 走路 抬头 看到 店家 吃 味道 好吃 鱼 嫩 服务 下次 机会 还会 	__label__0
环境 好 菜品 好 服务 好 棒 	__label__0
性价比 高 服务员 好 好吃 烤 酥 下次 继续 光临 	__label__0
三个 人 吃 集体 拉肚子 	__label__1
味道 真的 好吃 环境 不错 已经 第三次 过来 菜 份量 够吃 不错 五星 好评   翡翠 包   蒜 香 带子 螺   咖喱鸡 	__label__0
不怎么样 以后 买 	__label__0
店里 每样 菜 喜欢 吃 已经 开店 后 第二次 吃 大爱 	__label__0
肉 店家     克数 店家     肉切 找 要钱     我切 肉 好肥 好肥 图片 差距 一点点     肥 膘 切下来 点 好   非要 卖 钱     我要 差评     以后 你家 	__label__0
吃 环境 味道 好吃 	__label__0
肉 臭味 真的 无 语 	__label__1
已经 吃 好 味道 好 价格公道 	__label__0
顾客 味道 好 菜品 新鲜 份量 棒棒 吃 上火 	__label__0
味道 好 送货 速度 很快 	__label__0
建议 放 点 韭菜 吃 有家 羊肉 粉 菜 比较 多一点 光吃 羊肉 粉 觉得 有点 腻 	__label__0
环境 好 服务 周到 地方 好找 菜 好吃 闺蜜 一起 第一次 尝试 泰国菜 失望 两个 人团 98 菜品 丰富 完全 够吃 吃 完 最 喜欢 木瓜 炖 雪 蛤 西 米糕 比较 喜欢 吃 偏 甜 东西 下次 还来 	__label__0
服务 太好了   卷   小 妹儿 一张 张 扫描   觉得 累 	__label__0
地方 挺 好找 服务态度 特别 好 万州 烤鱼 特别 美味 早有 听说 选择 香辣 口味 一段时间 精心制作 下 鱼 终于 端 刺 有点 选 草鱼 味道 真的 特别 好 量 很大 吃 饱饱 口味 真是 一绝 真的 慢慢 品尝 美味 至极 不虚此行 	__label__0
广东 人 来说 味道 挺 好 做 比较 正宗 	__label__0
味道 不错 四个 大人 一个 小孩 刚刚 好 	__label__0
买 蛋糕 时 团购 每次 买 卡 蛋糕 划算 	__label__0
好吃 很久没 吃 满意 	__label__0
筷子 已经 发霉 发黑 看下 	__label__1
他妈的 吃 拉肚子 死 羊肉 	__label__1
顾客 老板 查 一下 记录 知道 恶意 评论 吃 今天 第一次 吃 虫子 真的 反胃 彻底 食欲 是不是 说法 卫生 问题 真的 堪忧 	__label__1
太 难吃 没得 味道 分量 以外 实在 难吃 记得 之前 没得 难吃 换 人 	__label__0
好吃 团购 便宜 速度 赞 	__label__0
米饭 味道   里面 吃 两个 蚊子 包子 	__label__1
味道 超好 喜欢 特别 酒 强烈推荐 桂花酒 	__label__0
环境 不错 味道 上菜 速度 太慢 	__label__0
味道 挺不错 分量 茄子 好吃 有点 辣 	__label__0
做 卫生 朋友 喝 一个 头晕 一个 肚子疼 再也 这家 搞 毛线 	__label__1
服务 好 	__label__0
        味道 不错 方便 地理位置 好找 	__label__0
去过 服务 菜品 好 以后 还要 	__label__0
吃 好 牛肉 很嫩 每人 只 限购 张卷 	__label__0
店铺 位置 大学城 熙街 靠近 重 师大 南门 好找 老板 服务态度 超级 好 小伙伴 两个 人 微辣 特别 辣 很香 菜品 新鲜 挑 四十 串 端上来 很大 一份 吃 撑 重庆 美食 名不虚传 顺祝 店家 生意兴隆 	__label__0
一家 小店 老板 人 好 味道 超赞 油牛 感觉 经营 火锅 一种 情怀 	__label__0
价格 实惠 喜欢 服务 好 环境 棒棒 哒 	__label__0
超级 难吃   不想 吐槽   太 难吃 	__label__0
贼 难吃     没吃过 难吃     油像 地沟油     鱿鱼 新鲜     想 吃 死 人 	__label__1
游荡 步行街 忍不住 想来 一杯 夏天 节制 乱来 购买 两家 店 态度 挺不错 同样 口味 喝太多会 腻 最后 希望 贵店 弄 点 口味 团购 新品 再 祝 肥胖 快乐 	__label__0
应该 干锅 鸡皮 全是 鸡 皮肉 看不到 	__label__0
菜品 丰富 老板 人 好 菜品 新鲜 下次 还来 	__label__0
还行 之前 一直 龙湖 香 老坎 感觉 分量 足比 好 一点 南坪 比较 感觉 越 吃 越 咸 好像 	__label__0
口感 好 环境 好 孩子 喜欢 	__label__0
吃 超多 花椒 	__label__0
鱼 好吃 肯定 百分之百 死 鱼 	__label__0
看到 火腿肠 	__label__0
甜品 团购 划算 蜜瓜 椰奶 容量 目测 400ml 芝士 蛋糕 卖相 很乖 真的 很小 配摆盘 造型 巧克力 蘸 吃 星光 电梯 感觉 人来人往 晚上 排队 人 比较 饭 小 甜点 店员 友善 服务态度 好 落座 后 感觉 位子 比较 挤 	__label__0
一如既往 好     买 感觉 挺 好 	__label__0
一如既往 地好 顾客 服务 热情 	__label__0
好 已经 吃 味道 挺 好 花甲 好 	__label__0
以前 这家 吃 以前 团购 生意 好 现在 竞争 大嘛 现在 团购 美团 无意 看到 家 美团 买 一份 人餐 确实 以前 没买 团购 划得来 服务 味道 家 一直 超好 一条街 烤鱼 莫走 错 心 愉顺 之前 万州 烤鱼 现在 改名 巫溪 烤鱼 麻辣 烤鱼 ## 香辣 烤鱼 ## 田螺 	__label__0
好吃   分量 足 	__label__0
味道 好   以后 还会来   强烈推荐 	__label__0
烤鱼 味道 好 价格 实惠 下次 还会来 吃 	__label__0
吃 拉肚子 真的 点 有点 多分 两次 吃 吃 拉 两天 进食 食物 味道 好 里面 是不是 泻药 不敢 点 毛肚 问题 吃 苦 	__label__1
位置 好找 环境 舒适 干净 卫生 味道 好 	__label__0
那天 临时 决定 团 四人餐 以前 去过 印象 特别 好 这次 朋友 再次 团 周末 结婚 办席 特别 南滨路 走 会儿 赶到 酒家 小朋友 办 周岁 宴席 大厅 没位 找 小包 间 平时 收 100 元 包间 费 那天 情况 特殊 收 五十 菜品 依然 不错 新鲜 够味 美 朋友 挺 赞 	__label__0
菜 口味 分量 有点 少 三个 大人 一个 小孩 不够 吃 	__label__0
下单 半小时 发货 申请 退款 拒绝 山竹 多久 卖出去 黑 地方 硬 没法 吃 	__label__0
酸 豇豆 肉沫 煲仔饭 里面 发现 15 厘米 左右 头发 一截 钢丝 球 胃口 吃 下去 	__label__1
好吃 便宜 划算 好喝 饮品 	__label__0
老板 接电话 不耐烦 服务 差到 一定 送餐 态度 不好 	__label__0
团购 没什么 区别对待 服务 周到 味道 麻辣 摆 	__label__0
好吃 划算 两个 人 吃 完 打包 回家 吃 	__label__0
特色 土豆片 鱼鳅 片 毛肚 鸭肠 顾客 团购 划算 	__label__0
头发 挑出 三团 饭 里面 头发 照片 能传 照片 传上去 	__label__0
打开 盒子 菜 菜 上面 一根 头发 晕 	__label__1
味道 好 环境 好 价格 合适 值得 品尝 	__label__0
味道 不错 蹄花 环境 	__label__0
吃 好 几次 味道 位置 比较 好找 	__label__0
好吃 主要 小孩 喜欢 	__label__0
家 吃 这次 真的 太 失望 以后 再 买 老公 想 吃 粉蒸肉 点 一份 有点 酸臭 味道 确定 老公 一吃 馊 变味 外卖 不顾 招牌 	__label__1
夫妻 肺片 里面 吃 一个 蟑螂     没得 话 说 以后 点 	__label__1
老板 人 好 位置 好 味道 不错 推荐 	__label__0
好吃 辣辣的 分量 位置 好找 	__label__0
第三次 这次 充了 会员 服务 真心 好 心情 不好 坐坐 芒果 班戟 真的 好吃 新鲜 芒果 双皮奶 好吃 安静 歌 好听 以后 闺蜜 约会 赞 一个 O ∩ ∩ O 	__label__0
环境 超级 好   好   以后 还会来 	__label__0
黑椒 牛排 这家 店好 几次       说实话 不错         推荐 身边 朋友       说 	__label__0
难吃   海鲜 粥 感觉 吃 胡椒 味来 以前 味 感觉 像是 味精 加 胡椒 	__label__0
味道 好吃     关键 店好     火锅     下次 尝尝 	__label__0
菜品 环境 好 味道 不错 值得 一吃 	__label__0
好吃 连续 吃 半个 多月 每天 买 工作人员 认识 还给 我现 做 新鲜 鱿鱼 老主顾 哈哈哈哈 	__label__0
不错 辣 吃 尝试 下 菜 新鲜 现切 老板 热情 	__label__0
抵用 块 只花 4.9 加 角买 五个 面包 超 划算 	__label__0
味道 真的 不错 最爱 虾 年糕 	__label__0
味道 不错 分量 挺足 吃 很饱 披萨 牛排 好吃 满意 	__label__0
环境 不错 味道 好吃 正宗 下次 还会来 	__label__0
地方 好找 服务 不错 西瓜汁 好喝 	__label__0
女朋友 一起 情侣 吃 分量 足够 男 推荐 自助 	__label__0
菜品 吃 几次 味道 服务员 态度 挺 好 上菜 一个 男 态度 相当 恶劣 	__label__0
量 太少 鸡杂 	__label__0
一直 约定 蛋糕 食材 新鲜 做工 精细 一如既往 喜欢 	__label__0
蛋糕 不错 服务态度 	__label__0
菜品 新鲜 份量 很足 味道 巴适 值得 推荐 服务 提高 	__label__0
顾客 满意 每次 必点 	__label__0
好吃 地方 好找 人 环境 好 适合 家人 聚会 朋友 聚餐 好去处 	__label__0
刨 酸奶 好吃 一直 最 爱 很棒 	__label__0
小朋友 吃   上菜 慢   比较满意 	__label__0
味道 不错 忘 评价 老婆 吃 	__label__0
全 五分 好评     点 杨枝 甘露 白雪 黑糯米 两 份量 足 味道 清鲜 看出 用心 做   厨师 后台 认真 样子   服务员 高素质 态度   环境 干净 装修 特色   特别 满意 期待 再次 团购 	__label__0
干净 卫生 味道 很棒 天天 下班 吃 一天 不吃 想 	__label__0
第二次 第一次 感觉 鸡爪 卤水 没想到 这次 有过之而无不及 呵呵 小票 分量 优惠券 扣 买 48 块 小票 扣除 优惠券 46 太会 做生意 鸡爪 一次 好吃 只 感觉 很麻 辣 一点 糯 晚上 口干舌燥 喝 好多 水 再有 下次 	__label__0
辣味 价钱 贵 说 看到 全是 泡 辣椒 想 远点 菜 费点 钱 好吃 没关 糸 三个 菜加 45 快递费 一起 26o 元 真是太 失望 知道 好评 	__label__0
他家 菜品 有点 淡 喜欢 重 口味 喜欢 最 喜欢 他家 西湖 牛肉 羹 干捞 粉丝 虾 每次 必点 菜品 比较 符合 口味 上菜 速度 有点 慢 希望 改进 一下 店面 位置 好找 新世界 楼 坐 直梯 下来 好找 	__label__0
行 挺 干净 比较 喜欢 吃 肉 	__label__0
老婆       说 上次 路过 看到 这家 店 今天 吃 试试 感觉 最 满意 服务 挺不错       味道 下次 家庭 聚餐 	__label__0
差评 太差 偷工减料 	__label__0
环境     超级 棒     今天 还要     哈哈哈 	__label__0
只能 说 商家 操作 实在 上心 12 点多 钟点 餐 点钟 实际 时间 多花 50 分钟 	__label__0
态度 真的 不好 之前 买 现在 觉定 买 送货 下个 楼 非要 走上 有毒 	__label__0
不错 环境 好 干净 服务 热情 	__label__0
好吃 肉 新鲜 米饭 坏 	__label__1
吃 拉肚子 差评 	__label__1
挺 正宗 川菜 味道 好 	__label__0
吃 几次 不错 辣椒 舒服 	__label__0
顾客 想 说 菜品 分量 新鲜 程度 32 个赞 前台 美女 每次 黑 热情 下次 还会 光顾 	__label__0
好吃 卫生 环境 不错   串串   鲜鸭肠   麻辣 牛肉   鸭肠   鲜 毛肚   鸡爪 	__label__0
吃 好 几次 价格便宜 菜品 不错 吃火锅 只加 块钱 划算 	__label__0
上菜 速度 超级   配菜 千叶 豆腐 好吃   总体 不错 	__label__0
米饭 里面 塑料 	__label__1
味道 外卖 干净 差评 两点 建议 请 配送 点 餐巾纸     米饭 类 配点 泡菜 炒饭 嘞 些 吃 油 	__label__0
明明 点 三份 米饭 两份 量 太少 只 够 两个 人 吃 说 打扰 一个 人 吃 	__label__0
感觉 挺不错 一种 酒吧 氛围 服务员 年轻 活力 烤鱼 味道 不错 服务 不错 一直 找 不到 找 半天 	__label__0
满意 第二次 以后 吃 团购 好 	__label__0
吃 最 好吃 烤鱼 吃 烤鱼 已经 绝望 	__label__0
真的 很无语   半天 不说   打开 里面 苍蝇 上面   真心 难吃   鸡蛋 坏 	__label__0
态度 好 服务 好 味道 好 值得 购买 	__label__0
团购 划算 味道 不错 	__label__0
回锅肉 套饭 ## 泡椒 肉丝 炒河粉 ## 香脆 馄饨 第一次 点 味道 好 这次 很差 回锅肉 晓得 回 次锅 里面 肉 黑 硬邦邦的 豆干 烂 绵 扎扎 一夜之间 换 厨师 难吃 至极 再来 回锅肉 套饭 ## 泡椒 肉丝 炒河粉 ## 香脆 馄饨 	__label__0
不错 噢 一如既往 地好 大学 城里 这家 性价比 高 肉 新鲜 	__label__0
味道 好 新鲜 	__label__0
土豆丝 馊 菜 分量 	__label__1
芝士 浓厚 味道 不错 服务 热情 下次 还会来 黑礁 牛柳 意面 玉米浓汤 值得 推荐 	__label__0
家点 以前 筷子 少 南瓜 烂成 粥 逗 说 这次 直接 吃 蟑螂 壳 壳 说 下次 补 一份 补 一份 未必 找 个整 还怪 外卖 问题 弄 称 抖 	__label__1
来说 喜欢 多大 一锅 自助 菜品 划算 	__label__0
给力 味道 好吃 服务态度 下次 一定 还来 	__label__0
真心 好吃 害得 重新 买 	__label__0
今天 第一次 点 砂锅 冒菜 吃 馊 坏 	__label__1
味道 真的 好 棒棒       强烈推荐 	__label__0
菜品 新鲜 老板 热情 超级 划算 推荐 	__label__0
位置 好找 中渝爱 门口 九点 吃 排队 味道 好吃 两个 人 吃 中辣 感觉 好辣 吃 好多 剩 菜 动 服务员 态度 不错 说 辣得 想 办法 加 点 东西 辣 菜量 足 值得 下次 继续 支持 菜品 新鲜 	__label__0
服务 热情 环境 好 味道 不错 	__label__0
阿姨 热情服务 好 量 足 好吃 	__label__0
味道 不错 工作餐 好 选择 	__label__0
有个 老头 态度 点 不好 想 骂 一把 年纪 	__label__0
麻辣 鲜香 口味 独特 强烈推荐 	__label__0
筷子   卤肉饭 太甜 	__label__0
味道 服务 上菜 速度 不错 下次 再 	__label__0
地址 好找 肉 不错 菜品 素菜 比较 少 上菜 蛮快 朋友 说 冰淇淋 王老吉 喝到 赞 菠萝 好吃 朋友 一致 觉得 菠萝 外面 好 好吃 还会 再 不错 	__label__0
味道 挺好吃 牛肉 特别 嫩 好吃 黑椒 汁 有点 辣 总 不错 下次 还要 吃 	__label__0
味道 好 值得 一去 尤其 小面 态度 好 	__label__0
味道 超级 棒 大幅 土豆泥 特别 好吃 刺身 分辨 挺 新鲜 咖喱饭 不错 	__label__0
菜品 味道 好 服务员 热情 操作 专业 餐厅 环境 干净 舒服 特别 推荐 它家 组合 锅 自由 搭配 三到 五种 菜品 酱汁 选辣 不辣 	__label__0
鱼够 新鲜 品种 喜欢 吃 鱼 不二 之选 吃 中华鲟 黄辣丁 松花 鱼 下次 想 吃 鱼 	__label__0
芒果 酸 吃   下 	__label__0
好评 价格 实惠 分量 很足 吃 人餐 剩 味道 不错 老板 热情 送 一份 酥 肉 推荐 	__label__0
不错 服务 挺 好 推荐 	__label__0
吃 吐 拉 再来 	__label__1
菜品 比较 味道 不错 工作人员 态度 好 下次 还会 继续 光顾 	__label__0
老板 差别 好像 有点 感觉 坑 样子 	__label__0
酱肉 汤包 ## 鲜肉 汤包 两个 汤包 剩 吃 嘴里 全是 怪味 闻 一下 变质 拿来 卖 	__label__1
口味 份量 不错 环境 服务 	__label__0
味道 不错 面块 好吃 四个 人 吃 剩 些 	__label__0
第一次 订 真的 无语 17 25 订 19 第一次 遇到 慢 打电话 催 没什么 算了 以后 吃 比较 谱 	__label__0
好吃 吃 推荐 	__label__0
味道 巴适 安逸 超级 喜欢 环境 爷 干净 感觉 好 	__label__0
去过         双椒鱼 不错 推荐 	__label__0
我点 肉 羊杂 以后 发现 外卖 骗人 你点 加多少 东西 重视 外卖 	__label__0
不错 两次 服务态度 好 分量 足 便宜 味道 不错 	__label__0
环境 特别 棒   喜欢 店 里面 很大 镜子   老板 做 喝 特别 认真   莫吉托 味道 真的 不错   装修 一定 下 功夫     夏天 喝 特别 舒服   位置 特别 好找   花儿 朵朵 下面 一点   DIY 饮品   以后 光顾 	__label__0
老板 人 好   赶早 动车   住   想 吃火锅 找 下 发现 这家 挺近     点 微辣 鸳鸯锅   不吃 辣 尝 一下 味道 不错 真的 吃   油碟 一次性 图   蒜 醋 佐料 加 西瓜 吃 只能 吃 西瓜 	__label__0
点 里脊 送 无 语 	__label__0
环境 好 服务 挺 好 牛魔王 黑砖 好喝 	__label__0
好吃 忘 拍照 菜品 丰富 肉类 比较 新鲜 	__label__0
位置 日 月光 背后 交巡警 大队 向上 走 找 不到 老板娘 跑 接 态度 好 环境 味道 吃 完 适合 吃 喝 瓶 国宾 10 块钱 评论 说 自带 酒水 不好意思 自带 本来 团购 便宜 不想 老板 亏本 	__label__0
第二次 喜欢 港点 味道 不错 性价比 高 	__label__0
一如既往 好 口感 超好 爱上 椒 麻味 服务态度 鱼 鲜香 入口 肉 嫩 滑 爽 	__label__0
太 喜欢 每次 吃 真的 好吃 一如既往 喜欢 下次 还会 	__label__0
吃 以后 拉 三天 肚子 医院 治疗 肠胃炎 输水 花 800 肚子疼 死 晚上 睡 不好 吃 吐 再也 点 这家 希望 以后 少 点 外卖 一个 教训 	__label__1
回 重庆 几个 生日 买 蛋糕 	__label__0
这是 回锅肉 请 告诉 回锅肉 看着 食欲 送 外卖 傻子 说 明显 路线 知道 真的 点 后悔 应该 看看 评价 原来 差 真是 后悔 点 	__label__0
味道 不错 服务 挺 好 	__label__0
太 难吃   臭味     醋   买 一眼 胃口   直接 甩   草 	__label__1
鸡排 一直 好吃 很大   味道 服务 不错 	__label__0
难吃   卫生   醉 撒 吃 吐 晓得 食材 一直 发臭 告诉 腥味 腥味 臭味 能够 分 清楚 下次 不来 	__label__1
味道 不错 性价比 高 	__label__0
服务态度 楞 好 	__label__0
忌 辛辣 吃 朋友 吃 说 味道 好 配菜 强烈推荐 家 辣子 田螺 味道 好 关键 分量 超级 赞 朋友 吃 好久 吃 完 	__label__0
分量 少     虫     送得 慢 	__label__1
环境 清幽 价格 实惠 	__label__0
轻轨 旁边 方便 味道 不错 	__label__0
味道 不错 好 服务员 热情 	__label__0
不错 一家 店 味道 挺不错 服务态度 好 分量 很足 三个 人 吃 完 很赞 	__label__0
环境 自然 没得说 别具一格 进门 即能 感受 浓厚 汉 文化 气息 菜品 精致 盛菜 器皿 独特 每个 好像 古董 特地 邀请 好友 吃 生日 宴 老板娘 实打实 才貌双全 特地 送 一份 菜 聚会 聊天 不二 之选 	__label__0
有点 辣 味道 好 	__label__0
菜 好吃 不错 速度 有点 慢 	__label__0
不错 喜欢 味道 好 环境 佳 已经 好 几次 	__label__0
挺 好 吃 附近 上班 第一次 朋友 一起 选择 番茄 老坛 酸辣 知道 吃 下菜 一直 原来 所有 东西 放进去 吃 觉得 有点 不可思议 这种 吃法 特色 味道 服务 好 送 饮料 真是 不错 下次 番茄 过桥米线 ## 酸辣 ## 橙汁 	__label__0
味道 好 价格 实惠 分量 足 摆 	__label__0
这是 第二回 不带 米饭 上次 说 下次 注意 关键 每次 整天 都还没 吃 一点 东西 情况 下 饭 辣 胃 受得了 打电话 不接 打星 一颗 星 不想 	__label__0
好吃 便宜 无好 货 	__label__0
黑黑的 苍蝇 招牌 鸭 食管 招牌 鸭 食管 里面 刚买 吃 完 放 一天 吃 完 看见 真的 扎心 老铁 感觉 喝 一碗 稀饭 最后 看见 两颗 耗子 真心 不敢 再来 买 吓人 	__label__1
菜品 新鲜 份量 足 老板 服务员 十分 热情 环境 比原 宽敞 隔壁 店 打通 	__label__0
这种 做法 独特 味道 好吃 这是 第二次 分量 足点 更好 可爱 	__label__0
环境 优雅 服务周到 适合 口味 不错 有空 再 坐坐 	__label__0
老板 太 黑心 撒 平菇 肉丝 套饭 肉 菜 吃 一口 直接 甩 没写 评价 第一次 遇到 这种 做生意 关门 太 恶心 	__label__1
馒头   说 少辣 很辣   鱼 上次 好吃   烤焦 	__label__0
骑手 服务 好   一颗 心 不想   盖子 扣好   差评 原因 简单   图   解释     海带 结有 沙   藕 酸   晓得 醋 放   吃       鸭 脖太辣   二十块 钱   十七 坨     吃 几个   鸭头 上次 好吃     说 新客 没点   店里 点         这次 真的 失望 	__label__0
重庆 呆 三年 老实 说 这家 能排 火锅 排行榜 第一 想到 写字楼 里 吃火锅 火锅 底料 很足 味道 浓郁 不燥 不热 第一次 点 排骨 好吃 不行 排 骨肉 美而嫩 码 辣椒 料 肉 沸腾 火锅 底料 一煮 入味 麻辣 牛肉 咬一口 满足 菜 喜欢 吃 已经 感觉 不到 撑 停不下来 还会 再 	__label__0
新开 店 味道 很正 	__label__0
想 说 送 小菜 送 送个 馊 意思 点 外面 碰到 这种 商家 馊 弄 饭 打开 味道 十里 飘香 艹     东西 剩 那种 感觉 台湾 号 卤肉饭 便当 ## 双拼 奥尔良 鸡排 十 牛肉饼 	__label__1
蛋糕 好吃 免费送 服务 好 下次 需要 再 	__label__0
工作餐 吃火锅 米线 林妹妹 林妹妹 参加 	__label__0
味道 巴适 价格 优惠 以后 吃 	__label__0
第一次 买 这家 东西 超 难吃 	__label__0
速度 今天 紫米 不错 绿豆 味 棒棒 哒 	__label__0
店 毛血旺 送 米饭 米饭 收钱 消费者 有点 接受 	__label__0
超过 配送 时间 太久 太慢 催 两次 送来 	__label__0
味道 好吃 价格 优惠 服务 不错 	__label__0
鹌鹑蛋 酸菜 米线 可乐   可乐   服务态度 差 	__label__0
双皮奶 勺子 锅巴 洋芋 难吃 送来 冷 点 一个 小时 送到 没点 别点 量 特别 少 	__label__0
太 超值 好吃 酒店 菜品 很大 份 服务态度 好 	__label__0
不错 量 足 两个 人 根本 吃不完 环境 干净 明星 周边 屋子 里面 mv 播出 喜欢 韩流 应该 喜欢 服务 到位 服务员 礼貌 	__label__0
味道 不错 位置 找 免费 停车 菜 分量 比较 足 	__label__0
两个 人团 三人餐 俩 算是 胃口 很大 吃 剩 只 足够 最 看着 量 真的 份儿 足味 正 实惠 鸭汤 味道 好极了 很大 一锅 胃口 较大 选择 三人餐 正好 下次 还会来 服务态度 好 服务员 客气 	__label__0
口味 不错 东西 好吃 实惠 	__label__0
味道 好 来过 态度 好 ✪ ω ✪ 	__label__0
去过 好 几次 带领 下 朋友 团购 他家 不错 	__label__0
环境 温馨 修身养性 菜品 美味 营养 健康 	__label__0
河粉 全是 节节 花 17 块 感觉 吃 全是 剩菜 品相 巨 糟糕 吃 几口 扔 吐 全是 节节 找到 一根 完整 河粉 口味 不好 全是 香料 味道 遂 差评 	__label__0
点 韭菜 送来 一点点 外卖 三点 多才 	__label__0
平常 拍照 评价 今天 虫子 确实 应该 米 线虫 老板 真的 注意 卫生 吖 	__label__1
孩子 吃 一人 一份 还加 米线 孩子 说 林妹妹 米线 越 吃 越 爱 吃 团购 节约 点 	__label__0
两次 人太多 团购 上菜 较慢 苍蝇 兄 蚊子 兄 算 不错 喜欢 喝 鸭汤 主要 	__label__1
食材 新鲜 特别 虾 吃 两个 人 肚子疼 一个 人 只 冷汗 拉肚子 做生意 良心 经营 以前 店里 常客 这一弄 差评 	__label__1
棒 味道 好 一家人 吃 开心 	__label__0
12 块钱 10 饺子 还要 收 配送费 餐盒 费 我能 好评 	__label__0
环境 好 菜品 好 味道 好 满意 以后 滴 	__label__0
不错 团购 服务 不好 菜品 丰富 朋友 觉得 不错 	__label__0
店员 态度 不错 	__label__0
蛋黄 酥 骗人 蛋黄 酥 单个   小   以为 喂给 王源 吃 学学 北京 鲍 师傅   蛋黄 酥   几倍 liu 榴莲 酥 榴莲 酥 榴莲   凤梨 酥 凤梨 酥 面粉 太多 吃 凤梨   抹 茶 红豆 蛋糕 太甜   新开 欺骗 消费者   迷你 袖珍 	__label__0
经济 实惠 口味 不错 配菜 丰富 	__label__0
好 几次 服务到位 味道 好评 	__label__0
味道 不错 服务 特别 好 环境 看起 干净 	__label__0
不错   下次 准备 吃 味道 好 	__label__0
平时 吃 烧烤 出现 肚子痛 拉肚子 情况 昨天 老公 吃 后   双双 拉肚子   出现 肚子 绞痛 情况 老公 伴有 作呕 症状 严重 怀疑 这次 菜品 问题 	__label__1
说好 时间 垃圾 	__label__0
人 吃 剩饭 剩菜 	__label__0
服务态度 极差   订单 直接 无视 掉   明明 做 显示 订单 已 送到   蛋糕 巨 难吃 	__label__0
一根 很长 很长 头发 麻烦 可不可以 注意 卫生 一点 真是 服 买 	__label__0
挺不错 	__label__0
加 一个 椒盐 骨架 六个 人 吃 很饱 朋友 聚餐 服务 好 	__label__0
每次 排队 爱上 正 新鸡排 每天 下班 路过 买 一份 贵 比大脸 鸡排 便宜 大脸 鸡排 现在 加盟 分 营 店 偷工减料 人 不敢 信赖 正新 鸡排 一股 春风 袭面 带来 鸡排 热潮 统一化 服装 管理 质量 杠杠 外焦里嫩 鸡排 肯德基 黄 渤 广告 正新 鸡排 鸡排 中 领导品牌 	__label__0
口感 好 送达 时间 晚 希望 以后 快点 	__label__0
大热天   送餐 迟到 20 分钟 计较 味道 只能 说 厨师 酱油 	__label__0
味道 不错 服务态度 老板 人 还好 	__label__0
服务态度 好 	__label__0
味道 地道 特别 棒 服务 人员 热情 上菜 速度 特别 赞 	__label__0
粉   都融 坨     确实 知道 下 口   呵呵 	__label__0
味道 比较 少 吃 串串 第一次 吃 好吃 串串 下次 过来 必来 那种 	__label__0
第一次 送 舍友 烤鸭 吃 忘不了 以后 班里 聚会 三峡 带份 烤鸭 每次 剩下 歌乐山 送 挺 开心 放假 吃 二人 餐 剩下 量 正好 不用 加 蔬菜 拼盘 吃 好吃 想 吃 习惯 吃饭 拍照 点 旅行 	__label__0
垃圾   说 香菜   打电话   脑子 有病 	__label__0
吃   今天 土豆 馊 	__label__1
味道 特别 蜗牛 肉 甜甜的 好吃 份量 很足 两个 人 吃 完 蔬菜 沙拉 味道 不错 里面 葡萄干 核桃 超爱 海鲜 面 味道 好 汤 浓 面 有劲 道 环境 不错 周围 比较 宽广 视野 好 服务 超级 赞 	__label__0
价格 实惠 分量 足 一家人 吃 饱饱 网上 团购 下次 还会 试一下 酸 汤味 	__label__0
老板 服务 好 饭 好吃 下次 还要 哈哈哈 	__label__0
速度 挺快 味道 纯正 	__label__0
好 服务态度 好 好吃 店 里面 装修 漂亮 	__label__0
真的 差评 确实 太 愉快 味道 肯定 不好 时间 太赶 鸡 咬 咬 不动芋 儿 生 吃 嘴巴 麻麻 感觉 吃 拉肚子 商家 改进 	__label__0
味道 不错 吃 一根 菜虫 瞬间 胃口 	__label__1
真的 难吃 东西 真的 好意思 做 外卖 吃 拉肚子 	__label__0
店面 好找 康居 西城 安尔达 专卖店 旁边 生意 不错 人 凉菜 好久 烤鱼 卖相 好 味道 不错 加 瓶 雪 碧 结帐 10 块 总体 价格 相差 	__label__0
晚到 一个 小时 味道 	__label__0
辣鸡 送货员 脾气 不小 不让 店里 外卖 服务态度 最后 一次 吃 这家 外卖 	__label__0
晓得 撒子 饭 卖 接近 20 块钱 一份 盒饭 比不上 真的 超级 难吃 饭 硬 说 菜 超级 难吃 吃 嘴里 感觉 馊 真的 无 语 吃 一口 直接 甩 老板 长 点心 	__label__1
菜品 质量 分量 足 吃 满意 	__label__0
不错 老板 人 不错 	__label__0
几次 觉得 送 蛋糕 哥哥 人 好 接电话 姐姐 亲切 下次 还会来 谢谢 咯 	__label__0
实惠 味道 还好 聚会 首选 	__label__0
吃饱 蛋糕 看图 以为 平时 叫外卖 盖饭 饭盒 实物 手掌心 包括 手指 部分 指 手掌 部分 味道 不怎么样 芒果 一小 盒 芒果 根本 称之为 芒果 蛋糕 	__label__0
好吃 强烈推荐 环境 不错 分量 足 鸭 鸭 有点 肥 	__label__0
味道 不错 结合 烧烤 味道 挺 好 推荐 	__label__0
服务态度 好     贡茶 好喝         好 	__label__0
肉串 少 一串 两碗 粉汤 洒 	__label__0
牛肉 特别 好吃 时间 够 	__label__0
环境 安静 味道 好吃 考虑 饭桶 菠萝 饭 可不可以 稍微 加点 分量 海鲜 炒饭 一股 蛋炒饭 感觉 咖喱 蟹 新鲜 好评 	__label__0
好吃 便宜 干净 态度 好 老板 好 真没想到 30 块 吃 好 超过 两块 说 不收 实在 太 好 强烈推荐 干油 碟 要加 几块钱 太 好吃 特别 配 鸡皮 	__label__0
内容 喜欢 味道 挺 清静 价格 贵 	__label__0
好吃 留香 排骨 周一 人 速度 很快 	__label__0
超级 无敌 难吃 鱼 外卖 差评 确实 商家 做 太 没良心 劝 慎重 选择 	__label__0
第二次 光顾 环境 好 服务态度 不错 食材 新鲜 偏爱 鳗鱼 寿司 大阪 烧 闺密 爱 甜 虾 寿司 烤 秋刀鱼 店长 人 超级 赞 送 梅子 酒 甜品 性价比 高 应该 目前 沙坪坝 最 好吃 一家 日料 店 下次 菜单 记得 做好 点 	__label__0
菜 好吃 环境 有点 小 下次 再 	__label__0
服务 好 现做 很快 奶油 现打 	__label__0
新 菜品 味道 不错 	__label__0
真的 很棒   第二次   感动 味道 	__label__0
太 难吃 啥子 鬼 汤 整个 鸡蛋 烧 里面 汤 虫 	__label__1
来店 消费 爽口 巴适 牛肉 安逸 消费 大众 	__label__0
辣鸡 超级 难吃 	__label__0
服务 热情 分量 足 一顿 吃不完 价格 实惠 	__label__0
油 倒 土豆泥 味 	__label__1
没洗 干净 虾肉 不好 	__label__1
挺不错   卖家 送过来   女朋友 喜欢 吃 	__label__0
服务员 太 态度 好 热情 汤 特别 好喝 	__label__0
好吃 太 喜欢 分量 足 服务 挺 好 	__label__0
直接 吃不下 饭 撒 	__label__0
团券 性价比 挺 高 选择性 菜品 不错 	__label__0
味道 好 团购 	__label__0
不错 公司 聚餐 味道 环境 不错 	__label__0
以前 喜欢 吃 味道 不错 狠 划算 	__label__0
味道 好 	__label__0
不错 不错   性价比 高   以后 机会 还会 再   再见 再见 	__label__0
菜 好吃 服务态度 好 送 一瓶 王老吉 	__label__0
真的 好吃 干锅 苦 下次 	__label__0
店里 有家 感觉 味道 好 好 几次 	__label__0
明明 牛肉 酸辣粉 整成 牛肉面 	__label__0
朋友 聚餐 吃 顿 火锅 味道 巴适 价格 不高 信价 一个 字 高 这家 底料 包装 精美 顺便 买 两合 带回家 送 闺蜜 	__label__0
知道 牛肉 咖喱 变质   吃 第二天 拉水 	__label__0
吃 拉肚子 肚子 很痛 感冒 	__label__1
不错 	__label__0
性价比 高 好吃 同事 聚餐 喜欢 菜品 比较 丰富 韩国 烤肉 最 爱 川菜 不错 秋刀鱼 有点 遗憾 	__label__0
同样 配方 好 味道 好多好多 回   真心 不错 	__label__0
水果 新鲜 坏 千层 做 不好 	__label__1
知道 第几次 吃 室友 过来 吃 现在 涨价 菜品 肉类 菜 品种 选择 鸡翅 五花肉 排骨 好吃 素菜 种类 好像 银耳 羹 做 好 好吃 喜欢 吃 素菜 过来 提个 小小 建议 菜品 应该 加个 金针菇 更好 	__label__0
太 难吃   郡 花都   新鲜   没熟 	__label__1
这次 买 两袋 土司 两个 泡 芙 回来 确实 感觉 超级 划算 一买 完 屯 一张 券 担心 到时候 优惠券 活动 取消 掉 土司 应该 新鲜 感觉 软 香 味道 不错 今天 泡 芙 感觉 外壳 有点 太硬 不像 之前 香软 	__label__0
好 味道 越来越 好 服务 好 	__label__0
这家 味道 最 好吃 菜品 新鲜 	__label__0
团购 价格便宜 分量 足 一个 人 吃 很饱 	__label__0
特别 备注 多放 几包 辣椒 一包 	__label__0
吃 开心   小伙伴 一起 吃     之前 姐姐 一起 吃 觉得 好 好吃   这次 推荐 吃   真是 吃 好开心   两人份 吃得饱   最后 两 撑 肚儿 离开   酒好 好喝 感觉 下次 还要 酒   哈哈哈哈   喜欢 喝酒 	__label__0
今天 早上 馊 	__label__1
这是 收拾 顾客 米饭 好 硬 凉面 请问 辣椒 里面 加 辣椒 精 有没有 尝尝 根本 吃 好辣 根本 咸味 盐 是不是 钻石 还贵 舍不得 放 有史以来 第一次 差评 真的 再也 不来 凉面 动 动 路边 那种 凉面 难吃 辣 办法 咸味 原来 收拾 顾客 得罪 宵夜 不让 吃饱 看清楚 要求 做 凉面 就别 上架 	__label__0
不错 一次   	__label__0
不错 服务到位 菜品 希望 换 一下 更好 	__label__0
几百年 送 不来 第一 遇到 速度 	__label__0
不错 海鲜 粥 味道鲜美 团购 划算 	__label__0
服务 好 周到 上菜 环境 优雅 味道 好   秘制 烤鸭 	__label__0
晚 半个 小时   以前 好吃   辣味 	__label__0
知道 这是 鬼 配送 两个 小时 路程 远 理解 食物 里面 虫子 爬 股酸 臭味   包装 损坏 好意思 拿给 真的 差评 吃 高蛋白 沙拉 方便 烦请 商家 接单 招牌 名声 最好 保留 无以 名状 	__label__1
划算 老板 态度 好 菜 口味 不错 新鲜 分量 很足 	__label__0
距离 1.9 km 选 烧烤 凌晨 2.40 商家 接单 送到 凌晨 3.52 宵夜 成功 弄 成 早餐 东西 不全 点 两天 刀鱼 只 送 一条 说 第二天 转给 现在 依然 谢谢 商家 漫不经心 体验 一把 钱 在线 支付 王 赶脚 	__label__0
说实话 差评 好   份量 真的 少   块 点 一份 玉米 肠   一共 坨   外卖 1.5 	__label__0
生意 火爆 不行 	__label__0
味道 超级 赞 姐姐 特别 和蔼可亲 喜欢 	__label__0
菜品 好吃   环境 	__label__0
买 火锅 底料       快递       快递 掏 邮费       味道 不错 	__label__0
抱歉 这么久 评论 记得 当时 画面 画面 太 美 店里 养 宠物 相亲相爱 厨房 餐厅 沙发 角 嬉戏 打闹 好 不自在 出现 太快 溜 太快 拍 照片 真 可惜 之后 朋友 种种原因 再 觉得 可惜 再也 看不到 那天 场景 只能 保存 记忆里 	__label__0
味道 真心 好吃 以为 重庆 做个 水 煮 口味 东西 分 分钟 事 味道 不麻不辣 不香 巨贵 一百块 一份 真的 一颗 星 不想 	__label__0
不错 第一次 吃 这是 第二次 弟弟 老婆 吃 	__label__0
好吃 火锅 米线 地道 	__label__0
环境 好 菜品 新鲜 	__label__0
第二次 买 券 第一次 吃 全 榴莲 吃 有点 闷人 这次 选 一半 榴莲 一半 芒果 这次 吃 完 芒果 不错 服务 一如既往 好 大年 30 提前 送过来 几次 电话 直接 送上门 送 东西 这次 过年 送 对联 红包 服务 杠杠 不错 选 蛋糕 选 这家 蛋糕 松软 入口 化 下次 还会订 口味 口味 吃个 一遍 	__label__0
鸭汤 味道 特别 好 份量 足 店 很小 人情味 十足 太 喜欢 喝 汤 地方 稍微 一点 偏 味道 好 再 远 吃货 找 过来 	__label__0
吃完饭 电影 现在 评价 ฅ ω 实惠 老板 阿姨 人 超级 nic 	__label__0
吃 拉肚子 昨晚 今天 现在 舒服 一个 人 估计 问题 两个 舒服 	__label__1
很漂亮 巧克力 店家 服务 好 买来 送 朋友 朋友 喜欢 	__label__0
没想到 土豆泥 变成 土豆丝 	__label__0
一直 喜欢 这家 好 	__label__0
味道 挺 好 分量 少 7.5 折 划算 原价 不划算 	__label__0
价格便宜 量足 上菜 速度 装修 别致 	__label__0
蛋糕 好 服务 周到 	__label__0
不错   吃   肥而 不腻   味道 很辣   分量 太少   配 店里 面超 好吃 	__label__0
好 服务态度 相当 好 上菜 环境 不错 值得 再 	__label__0
团购 菜品 少 味道 不错 汤 不赖 价格 实惠 滴   木瓜 枸杞 银耳 甜汤   肉沫 茄子 	__label__0
米饭 买   送   退钱 	__label__0
好吃 好吃 吃 几次 下次 还来 	__label__0
不想 说 难吃 蚂蚁 上树 ## 红烧 豆腐 	__label__0
老板 人超 好 o     30 坐     小时 主要 环境 好人 nice 想 赖 走 	__label__0
忠实 顾客 好吃 服务 好 下班 怠慢 	__label__0
呵呵 你家 开花 肠真 新意 	__label__0
顾客 说 真的 太 喜欢 	__label__0
味道 挺 好   菜品 实惠   地段 方便   顾客     希望 团购 一直 搞 下去 	__label__0
去过 几次 服务态度 好 团购 怠慢 味道 	__label__0
最 难吃 洋芋         辣味   一点 盐味 没得     反正 好 难吃 	__label__0
难吃 少 态度 消极 	__label__0
儿子 一直 喜欢 吃 这家 价格便宜 味道 好 满分 	__label__0
服务态度 好     东西 不错     下次 还要 	__label__0
顾客 说 骨头 真的 一块 骨头 满意 好吃 好评 噻 	__label__0
送 两个 小时 做 	__label__0
图片 骗人 烧 仙草 大满贯 奶茶 ➕ 龟苓膏 	__label__0
吃 苍蝇 好肥 一只 以后 再也 不吃 恶心 	__label__1
味道 不错 说好 团 两条 只 团 一条 	__label__0
味道 甚 好 料足 值得 推荐 本来 不想 吃 忍不住 点 	__label__0
送上门 态度 太 差 欺骗 说 保安 不让 进 30 分钟 一个多 小时 	__label__0
这家 麻辣烫 吃 觉得 好吃 干净 卫生 米饭 吃 整碗 	__label__0
味道 好 服务 好 团购 实惠 两个 足够 	__label__0
之前 吃 一次 感觉 今天 想 吃 送过来 包装 变 味道 变 味道 盐 辣味 知道 是不是 换 厨师 这次 真的 难吃 爆 吃 几个 全部 扔 	__label__0
分量 足 剩 好多 吃 完 	__label__0
味道 不错       赞       下次 	__label__0
味道 不错 老板 人 好 	__label__0
好 买过 一如既往 好 	__label__0
性价比 高 吃得饱 人多 上菜 慢 下次 还会 	__label__0
老板 态度 好 儿子 说 好吃 物有所值 	__label__0
第二次 觉得 牛排 最 重要 环境 好 朋友 服务态度 好 耐心 明天   20   点里 气球 挺 浪漫 氛围 做 好 	__label__0
配送 慢不说   打开 盒子 绿豆汤 里面 只 虫   瞬间 食欲 	__label__1
装饰 风格 偏 北欧 休闲 环境 舒适 菜品 可口 分量 服务 OK 	__label__0
喝 好 几次 味道 真的 挺不错 	__label__0
好 难吃 	__label__0
服务 好 店面 干净 小面 味道 好 推荐 附近 人 尝尝 	__label__0
吃 好 实惠 性价比 高 	__label__0
好吃 送 很慢 	__label__0
不错 味道 好 店面 比较 干净 老板 比较 热情 	__label__0
里面 吃 两只 蚊子 当时 想 评论 不想 忍 	__label__1
潮 火锅 称之为 世上 最 热情 火锅 去过 好 几次 朋友家 人来 服务 好 好吃 之前 专门 跑 观音桥 现在 南坪 方便 喜欢 值得 	__label__0
味道 真心 好吃 环境 特别 好 喝 饮料 不错 	__label__0
住 楼上 天天 路过 声音 好 排队 第一次 品尝 好久 孩子 一直 趴在 窗口 鸭子 口水 直流 鸭子 终于 等待 值得 鸭子 很大 只 吃不完 打包 小吃 零食 孩子 开心 值得 推荐 	__label__0
酸菜鱼 好吃 	__label__0
好 一个 聚餐 地方 	__label__0
前两天 点 几次 今天 这次 吃 完 发现 汤 泡饭 最 下面 只 死 苍蝇 泡 软 想到 之前 喝 好多 汤 今天下午 晚上 吃 吐出来 	__label__1
好 一如既往 好 每次 	__label__0
老板 热情   服务态度 好   环境 不错   牛排 很嫩   超级 好吃 	__label__0
不太 干净 吃 完后 现在 一直 拉肚子 太难受 晚上 睡觉 希望 改进 	__label__1
现在 别家 烤肉 不想 吃   老板 贴心 建议 你点 餐点   棒 	__label__0
味道不好 吃食 材 新鲜 点 根本 烤齐 年糕 影子 看到 	__label__0
服务态度 好   寿司   生 蚝   扇贝   鲜榨 果汁   海鲜 烤肉 火锅   冰激凌   毛肚   果汁   木瓜 炖 雪 蛤   白灼 虾   蒜蓉 扇贝 	__label__0
现在 外卖 越来越 不行 偷工减料 这是 我点 功夫 鸡腿 两块 儿 我点 冰粉 送过来 一碗 儿 糖水 再也 不到 买 	__label__0
一如既往 服务 不错 小吃 不错 团购 好几张 这次 父母 过来 吃 说 挺 好 	__label__0
安静 美好 	__label__0
已经 吃 两次 拉肚子 新鲜 脏 	__label__1
味道 好 分量 足 等待时间 太长 	__label__0
物美价廉 味道 好 服务 很棒 环境 舒适 值得 推荐 下次 还来 	__label__0
晚 十五分钟 吃 触角 很长 虫子 实在 恶心 	__label__1
真的 我服 这家 买 好 小 西瓜 这次 买 一份 榴莲 真是 醉 商家 几个 意思 真是 厉害 这点 完 	__label__0
位置 好找 环境 好 凉爽 嘈杂 黄焖 鸡 粉丝 味道 好 下饭 份量 足 价廉物美 订 三份 	__label__0
吃 有股 糊味 	__label__0
之前 吃 觉得 今天 吃 鸡杂 肠子 没洗 干净 吃 后 嘴巴 很久 腥味 一直 拉肚子 希望 卖家 重视 	__label__0
不错 店 顾客   现在 改喝 一个 柠檬 红   分量 很足   喜欢 这家 店 柠檬 红茶 	__label__0
味道 蛋糕 比较 松软   唯一 觉得 不足 芒果 新鲜 	__label__0
回头客 服务 挺 好 排队 很快 味道 不错 	__label__0
好评 味道 不错 	__label__0
菜品 没什么 炒饭 好吃 肥肠 吃 股 酸味 吃 几个 坏 	__label__0
知道 多久 水果 吃 之后   吐 下泄   骗人   不想 骂人   进口 	__label__0
便宜 好吃 以后 光顾 	__label__0
菜品 新鲜 藕 没洗 藕片 干 豆腐 很辣 分量 少 下次 再也不会 这家 吃 	__label__1
一如既往 赞 觉得 南坪 亿象 城马 那家 好 一点 	__label__0
昨天晚上 吃 今天 中午 一句 话 老板 人好 菜品 不错 	__label__0
菜品 新鲜感 味道 不错 折扣 力度 不错 	__label__0
牛排 不错         服务 好 	__label__0
看到 价格便宜 团 试试 味道 惊喜 老板 服务态度 好 团购 偷工减料 炒锅 小帅哥 亲们 支持 创业 	__label__0
卫生 干净 味道 好吃 团购 价格 实惠 	__label__0
乌鸡汤 里面 吃 钢丝 球     真的 加餐   不敢 继续 吃 下去 	__label__1
性价比 极高 这种 优惠 一定 	__label__0
强烈推荐 奶茶 真的 超 好喝 团 好 几次 	__label__0
完美 你家 东西 完美 形容 附赠 昆虫 野味 完美 再 吃 你家 东西 SB 	__label__1
味道 不错 板栗 好吃 团购 不错 	__label__0
吃 拉肚子 今天 已经 第三天 	__label__1
服务态度 好 外送 力 味道 不错 强烈推荐 	__label__0
味道 不错 吃 完 分量 足 环境 不错 	__label__0
不错 位置 好找 环境 干净 满意 	__label__0
太 难吃 只能 说 再点 骑手 态度 够 求 东西 送给 	__label__0
态度 好 口味 好 超级 喜欢 喝 顾客 	__label__0
环境 好 服务态度 好 好 几次 牛排 确实 巴实 	__label__0
饭 里面 苍蝇 丶 太慢 	__label__1
这家 店 不错呀 位置 好找 重庆 一中 旁边 环境 不错 关键 菜 分量 很足 吃 吃 好 烤鸭 外 酥 里 嫩 卤水 拼盘 好吃 很早 下午 30 当时 没什么 人 走 人 服务员 态度 好 下次 机会 还会 再 	__label__0
味道 好 店面 环境 舒适 菜品 分量 很足 三个 人 吃 吃 完 团过 几次 下次 还来 	__label__0
这是 鱼香肉丝 盖饭 	__label__0
味道 环境 清静 适合 朋友 聚餐 	__label__0
看图     我要   送 三杯 饮料   做生意 	__label__0
冰爽 好喝 老客户 一如既往 喜欢 	__label__0
说好 汤 骗人 	__label__0
地方 好找 环境 优雅 特别 味道 好 棒棒 哒 色香味 俱全 老板 服务周到 热情 大方 好 建议 品尝 	__label__0
超级 已经 几次 音乐 相伴 	__label__0
味道 好 划算 环境 不错 服务态度 不错 已经 顾客 	__label__0
吃   味道 不错   菜品 需要 更新 	__label__0
蛋糕 好吃 气泡 水 好喝 呵呵 觉得 蛋糕 分量 少 点 	__label__0
股羊 骚味 我点 牛肉 送 汤 好喝 	__label__0
面馆 虽小 真的 好 实惠 好吃 分量 足 服务 好 工薪族 首选 合租房 小伙伴 小 食堂 	__label__0
鸭头 切开 鸭 脖有 异味 鸭脚 干而 无味 	__label__1
看到 好评 过来 环境 传统 火锅 有点 西式 朋友 说 喜欢 关键 味道 超棒 吃 身上 牛油 味 服务员 说 植物油 火锅 生态 菜品 新鲜 团购 消费 实惠 人均 38 左右 辜负 跑 远 值得 推荐 下次 顺便 参观 一下 包房 好 力 感觉 好 高大 包房 消费 有点 小贵 拍 几张 照片 下次 发工资 包房 试一下 	__label__0
味道 不错 早点 晚 自助 	__label__0
干净 卫生 好吃 贵 	__label__0
分量 挺足 是因为 当时 饿 觉得 味道 辣白菜 辣酱 拌 腌制 好吃 服务态度 挺 好 主动 告诉 wifi 密码 饮料 挺 好喝   石锅 拌 饭   蜂蜜 柚子茶 	__label__0
西瓜   乐堡 啤酒 	__label__0
不错 环境 套餐 挺 划算 	__label__0
青 柠檬 味 好喝 	__label__0
搞 活动 买 划算 木桶 饭 吃 小妹 验券 一直 价格 喊 厨师 说 给验 说实话 当时 直接 不想 吃 这家 别家 意见 吃饭 一个 心情 价格低 服务态度 一定 到位 现在 竞争 一家 选择 	__label__0
今天 饭菜 感觉 前面 点 根本 一个 味 后面 想 一下 10 点 40 下 10 点 55 送到 微波炉 打热 送上来 老客户 以后 再点 	__label__1
地方 有意思 	__label__0
菜品 新鲜 服务 好 	__label__0
速度 价格便宜 味道 好 不错 	__label__0
